ID,Type,Chr,Start,End,Met_perc,Cyt_Met,Cyt_NoMet,Depth
SRR25023301_1_val_1_bismark_bt2_pe.bismark.cov,cases,chr13,32889392,32889392,14.010067114094,501,3075,3576
SRR25023301_1_val_1_bismark_bt2_pe.bismark.cov,cases,chr13,32889434,32889434,2.21040850587577,79,3495,3574
SRR25023301_1_val_1_bismark_bt2_pe.bismark.cov,cases,chr13,32889461,32889461,1.25979843225084,45,3527,3572
SRR25023301_1_val_1_bismark_bt2_pe.bismark.cov,cases,chr13,32889470,32889470,0.587412587412587,21,3554,3575
SRR25023301_1_val_1_bismark_bt2_pe.bismark.cov,cases,chr13,32889484,32889484,0.392047045645477,14,3557,3571
SRR25023301_1_val_1_bismark_bt2_pe.bismark.cov,cases,chr13,108867034,108867034,47.1933471933472,454,508,962
SRR25023301_1_val_1_bismark_bt2_pe.bismark.cov,cases,chr13,108867044,108867044,60.3909465020576,587,385,972
SRR25023301_1_val_1_bismark_bt2_pe.bismark.cov,cases,chr13,108867051,108867051,49.4877049180328,483,493,976
SRR25023301_1_val_1_bismark_bt2_pe.bismark.cov,cases,chr13,108867109,108867109,88.0368098159509,861,117,978
SRR25023301_1_val_1_bismark_bt2_pe.bismark.cov,cases,chr13,108867112,108867112,87.1297242083759,853,126,979
SRR25023301_1_val_1_bismark_bt2_pe.bismark.cov,cases,chr13,108867124,108867124,76.0491299897646,743,234,977
SRR25023301_1_val_1_bismark_bt2_pe.bismark.cov,cases,chr13,108867135,108867135,62.2564102564103,607,368,975
SRR25023301_1_val_1_bismark_bt2_pe.bismark.cov,cases,chr13,108867155,108867155,61.1909650924025,596,378,974
SRR25023301_1_val_1_bismark_bt2_pe.bismark.cov,cases,chr3,37034307,37034307,99.9285714285714,2798,2,2800
SRR25023301_1_val_1_bismark_bt2_pe.bismark.cov,cases,chr3,37034316,37034316,0.286020736503396,8,2789,2797
SRR25023301_1_val_1_bismark_bt2_pe.bismark.cov,cases,chr3,37034324,37034324,0.322118826055834,9,2785,2794
SRR25023301_1_val_1_bismark_bt2_pe.bismark.cov,cases,chr3,37034330,37034330,0.178890876565295,5,2790,2795
SRR25023301_1_val_1_bismark_bt2_pe.bismark.cov,cases,chr3,37034344,37034344,0.966356478167502,27,2767,2794
SRR25023301_1_val_1_bismark_bt2_pe.bismark.cov,cases,chr3,37034346,37034346,0.393841747225206,11,2782,2793
SRR25023301_1_val_1_bismark_bt2_pe.bismark.cov,cases,chr3,37034348,37034348,0.502152080344333,14,2774,2788
SRR25023301_1_val_1_bismark_bt2_pe.bismark.cov,cases,chr3,37034352,37034352,0.286327845382963,8,2786,2794
SRR25023301_1_val_1_bismark_bt2_pe.bismark.cov,cases,chr3,37034355,37034355,0.393841747225206,11,2782,2793
SRR25023301_1_val_1_bismark_bt2_pe.bismark.cov,cases,chr3,37034359,37034359,0.465616045845272,13,2779,2792
SRR25023301_1_val_1_bismark_bt2_pe.bismark.cov,cases,chr3,37034369,37034369,1.39245144741664,38,2691,2729
SRR25023301_1_val_1_bismark_bt2_pe.bismark.cov,cases,chr3,37034373,37034373,0.572450805008945,16,2779,2795
SRR25023301_1_val_1_bismark_bt2_pe.bismark.cov,cases,chr3,37034382,37034382,0.286225402504472,8,2787,2795
SRR25023301_1_val_1_bismark_bt2_pe.bismark.cov,cases,chr3,37034394,37034394,0.107334525939177,3,2792,2795
SRR25023301_1_val_1_bismark_bt2_pe.bismark.cov,cases,chr3,37034402,37034402,0.429491768074445,12,2782,2794
SRR25023301_1_val_1_bismark_bt2_pe.bismark.cov,cases,chr3,37034409,37034409,0.643776824034335,18,2778,2796
SRR25023301_1_val_1_bismark_bt2_pe.bismark.cov,cases,chr3,37034412,37034412,0.680272108843537,19,2774,2793
SRR25023301_1_val_1_bismark_bt2_pe.bismark.cov,cases,chr3,37034414,37034414,0.716075904045829,20,2773,2793
SRR25023301_1_val_1_bismark_bt2_pe.bismark.cov,cases,chr3,37034418,37034418,0.572655690765927,16,2778,2794
SRR25023301_1_val_1_bismark_bt2_pe.bismark.cov,cases,chr3,37034420,37034420,0.715051841258491,20,2777,2797
SRR25023301_1_val_1_bismark_bt2_pe.bismark.cov,cases,chr3,37034430,37034430,0.429645542427497,12,2781,2793
SRR25023301_1_val_1_bismark_bt2_pe.bismark.cov,cases,chr3,37034438,37034438,0.464949928469242,13,2783,2796
SRR25023301_1_val_1_bismark_bt2_pe.bismark.cov,cases,chr3,37034441,37034441,0.214745884037223,6,2788,2794
SRR25023301_1_val_1_bismark_bt2_pe.bismark.cov,cases,chr3,37034466,37034466,99.8923573735199,2784,3,2787
SRR25023301_1_val_1_bismark_bt2_pe.bismark.cov,cases,chr3,37034997,37034997,0.643896976483763,23,3549,3572
SRR25023301_1_val_1_bismark_bt2_pe.bismark.cov,cases,chr3,37035012,37035012,0.503919372900336,18,3554,3572
SRR25023301_1_val_1_bismark_bt2_pe.bismark.cov,cases,chr3,37035032,37035032,0.784533482768282,28,3541,3569
SRR25023301_1_val_1_bismark_bt2_pe.bismark.cov,cases,chr3,37035043,37035043,0.224026883225987,8,3563,3571
SRR25023301_1_val_1_bismark_bt2_pe.bismark.cov,cases,chr3,37035047,37035047,0.392156862745098,14,3556,3570
SRR25023301_1_val_1_bismark_bt2_pe.bismark.cov,cases,chr3,37035063,37035063,0.531468531468531,19,3556,3575
SRR25023301_1_val_1_bismark_bt2_pe.bismark.cov,cases,chr3,37035066,37035066,1.00783874580067,36,3536,3572
SRR25023301_1_val_1_bismark_bt2_pe.bismark.cov,cases,chr3,37035074,37035074,0.476057126855223,17,3554,3571
SRR25023301_1_val_1_bismark_bt2_pe.bismark.cov,cases,chr3,37035090,37035090,1.11950741673664,40,3533,3573
SRR25023301_1_val_1_bismark_bt2_pe.bismark.cov,cases,chr3,37035095,37035095,0.447427293064877,16,3560,3576
SRR25023301_1_val_1_bismark_bt2_pe.bismark.cov,cases,chr3,37035097,37035097,0.867861142217245,31,3541,3572
SRR25023301_1_val_1_bismark_bt2_pe.bismark.cov,cases,chr3,37035100,37035100,0.531914893617021,19,3553,3572
SRR25023301_1_val_1_bismark_bt2_pe.bismark.cov,cases,chr3,37035117,37035117,0.392266741384141,14,3555,3569
SRR25023301_1_val_1_bismark_bt2_pe.bismark.cov,cases,chr3,142297977,142297977,1.30597014925373,14,1058,1072
SRR25023301_1_val_1_bismark_bt2_pe.bismark.cov,cases,chr3,142298019,142298019,1.02707749766573,11,1060,1071
SRR25023301_1_val_1_bismark_bt2_pe.bismark.cov,cases,chr3,142298045,142298045,1.21155638397018,13,1060,1073
SRR25023301_1_val_1_bismark_bt2_pe.bismark.cov,cases,chr3,142298054,142298054,3.55472404115996,38,1031,1069
SRR25023301_1_val_1_bismark_bt2_pe.bismark.cov,cases,chr14,45604787,45604787,0.536193029490617,2,371,373
SRR25023301_1_val_1_bismark_bt2_pe.bismark.cov,cases,chr14,45604794,45604794,0.268096514745308,1,372,373
SRR25023301_1_val_1_bismark_bt2_pe.bismark.cov,cases,chr2,47596828,47596828,8.55640535372849,179,1913,2092
SRR25023301_1_val_1_bismark_bt2_pe.bismark.cov,cases,chr2,47596830,47596830,8.38407494145199,179,1956,2135
SRR25023301_1_val_1_bismark_bt2_pe.bismark.cov,cases,chr2,47596840,47596840,10.4351895180159,223,1914,2137
SRR25023301_1_val_1_bismark_bt2_pe.bismark.cov,cases,chr2,47596849,47596849,33.9596054485674,723,1406,2129
SRR25023301_1_val_1_bismark_bt2_pe.bismark.cov,cases,chr2,47596853,47596853,19.2037470725995,410,1725,2135
SRR25023301_1_val_1_bismark_bt2_pe.bismark.cov,cases,chr2,47596858,47596858,20.6475832942281,440,1691,2131
SRR25023301_1_val_1_bismark_bt2_pe.bismark.cov,cases,chr2,47596862,47596862,20.3660253402159,434,1697,2131
SRR25023301_1_val_1_bismark_bt2_pe.bismark.cov,cases,chr2,47596869,47596869,31.288056206089,668,1467,2135
SRR25023301_1_val_1_bismark_bt2_pe.bismark.cov,cases,chr2,47596883,47596883,29.2235294117647,621,1504,2125
SRR25023301_1_val_1_bismark_bt2_pe.bismark.cov,cases,chr2,47596885,47596885,13.3239171374765,283,1841,2124
SRR25023301_1_val_1_bismark_bt2_pe.bismark.cov,cases,chr2,47596887,47596887,15.5472052606858,331,1798,2129
SRR25023301_1_val_1_bismark_bt2_pe.bismark.cov,cases,chr2,47596897,47596897,14.8235294117647,315,1810,2125
SRR25023301_1_val_1_bismark_bt2_pe.bismark.cov,cases,chr2,47596900,47596900,10.320452403393,219,1903,2122
SRR25023301_1_val_1_bismark_bt2_pe.bismark.cov,cases,chr2,47596907,47596907,9.55294117647059,203,1922,2125
SRR25023301_1_val_1_bismark_bt2_pe.bismark.cov,cases,chr2,47596912,47596912,9.68500235072873,206,1921,2127
SRR25023301_1_val_1_bismark_bt2_pe.bismark.cov,cases,chr2,47596930,47596930,10.9595484477893,233,1893,2126
SRR25023301_1_val_1_bismark_bt2_pe.bismark.cov,cases,chr2,47596942,47596942,13.8157894736842,294,1834,2128
SRR25023301_1_val_1_bismark_bt2_pe.bismark.cov,cases,chr2,47630224,47630224,1.10544217687075,13,1163,1176
SRR25023301_1_val_1_bismark_bt2_pe.bismark.cov,cases,chr2,47630227,47630227,1.15990057995029,14,1193,1207
SRR25023301_1_val_1_bismark_bt2_pe.bismark.cov,cases,chr2,47630233,47630233,0.497100248550124,6,1201,1207
SRR25023301_1_val_1_bismark_bt2_pe.bismark.cov,cases,chr2,47630237,47630237,0.580431177446103,7,1199,1206
SRR25023301_1_val_1_bismark_bt2_pe.bismark.cov,cases,chr2,47630240,47630240,0.994200497100249,12,1195,1207
SRR25023301_1_val_1_bismark_bt2_pe.bismark.cov,cases,chr2,47630244,47630244,0.745033112582781,9,1199,1208
SRR25023301_1_val_1_bismark_bt2_pe.bismark.cov,cases,chr2,47630251,47630251,0.993377483443709,12,1196,1208
SRR25023301_1_val_1_bismark_bt2_pe.bismark.cov,cases,chr2,47630265,47630265,0.912863070539419,11,1194,1205
SRR25023301_1_val_1_bismark_bt2_pe.bismark.cov,cases,chr2,47630292,47630292,0.413907284768212,5,1203,1208
SRR25023301_1_val_1_bismark_bt2_pe.bismark.cov,cases,chr2,47630294,47630294,0.827814569536424,10,1198,1208
SRR25023301_1_val_1_bismark_bt2_pe.bismark.cov,cases,chr2,128051674,128051674,0.485436893203883,1,205,206
SRR25023301_1_val_1_bismark_bt2_pe.bismark.cov,cases,chr2,128051690,128051690,0.75,6,794,800
SRR25023301_1_val_1_bismark_bt2_pe.bismark.cov,cases,chr2,128051704,128051704,0.875,7,793,800
SRR25023301_1_val_1_bismark_bt2_pe.bismark.cov,cases,chr2,128051707,128051707,0.624219725343321,5,796,801
SRR25023301_1_val_1_bismark_bt2_pe.bismark.cov,cases,chr2,128051709,128051709,0.998751560549313,8,793,801
SRR25023301_1_val_1_bismark_bt2_pe.bismark.cov,cases,chr2,128051716,128051716,0.249376558603491,2,800,802
SRR25023301_1_val_1_bismark_bt2_pe.bismark.cov,cases,chr2,128051733,128051733,0.374531835205993,3,798,801
SRR25023301_1_val_1_bismark_bt2_pe.bismark.cov,cases,chr2,128051743,128051743,0.875,7,793,800
SRR25023301_1_val_1_bismark_bt2_pe.bismark.cov,cases,chr2,178787742,178787742,84.2364532019704,342,64,406
SRR25023301_1_val_1_bismark_bt2_pe.bismark.cov,cases,chr10,89619506,89619506,97.6435935198822,1326,32,1358
SRR25023301_1_val_1_bismark_bt2_pe.bismark.cov,cases,chr10,89619510,89619510,97.7205882352941,1329,31,1360
SRR25023301_1_val_1_bismark_bt2_pe.bismark.cov,cases,chr10,89619512,89619512,98.3823529411765,1338,22,1360
SRR25023301_1_val_1_bismark_bt2_pe.bismark.cov,cases,chr10,89619522,89619522,97.0652971386647,1323,40,1363
SRR25023301_1_val_1_bismark_bt2_pe.bismark.cov,cases,chr10,89619550,89619550,97.3529411764706,1324,36,1360
SRR25023301_1_val_1_bismark_bt2_pe.bismark.cov,cases,chr10,89619555,89619555,97.7941176470588,1330,30,1360
SRR25023301_1_val_1_bismark_bt2_pe.bismark.cov,cases,chr10,89619566,89619566,95.2906548933039,1295,64,1359
SRR25023301_1_val_1_bismark_bt2_pe.bismark.cov,cases,chr10,89619580,89619580,93.2303164091244,1267,92,1359
SRR25023301_1_val_1_bismark_bt2_pe.bismark.cov,cases,chr11,108093323,108093323,1.00558659217877,9,886,895
SRR25023301_1_val_1_bismark_bt2_pe.bismark.cov,cases,chr11,108093335,108093335,0.7847533632287,7,885,892
SRR25023301_1_val_1_bismark_bt2_pe.bismark.cov,cases,chr11,108093338,108093338,0.112107623318386,1,891,892
SRR25023301_1_val_1_bismark_bt2_pe.bismark.cov,cases,chr11,108093359,108093359,0.458715596330275,4,868,872
SRR25023301_1_val_1_bismark_bt2_pe.bismark.cov,cases,chr11,108093371,108093371,0.0,0,686,686
SRR25023301_1_val_1_bismark_bt2_pe.bismark.cov,cases,chr11,108093373,108093373,0.291120815138282,2,685,687
SRR25023301_1_val_1_bismark_bt2_pe.bismark.cov,cases,chr11,108093386,108093386,0.726744186046512,5,683,688
SRR25023301_1_val_1_bismark_bt2_pe.bismark.cov,cases,chr11,108093395,108093395,0.291120815138282,2,685,687
SRR25023301_1_val_1_bismark_bt2_pe.bismark.cov,cases,chr11,108093402,108093402,0.0,0,683,683
SRR25023301_1_val_1_bismark_bt2_pe.bismark.cov,cases,chr11,108093413,108093413,0.29806259314456,2,669,671
SRR25023301_1_val_1_bismark_bt2_pe.bismark.cov,cases,chr11,108093419,108093419,1.1887072808321,8,665,673
SRR25023301_1_val_1_bismark_bt2_pe.bismark.cov,cases,chr11,108093436,108093436,0.149253731343284,1,669,670
SRR25023301_1_val_1_bismark_bt2_pe.bismark.cov,cases,chr11,108093439,108093439,1.94029850746269,13,657,670
SRR25023301_1_val_1_bismark_bt2_pe.bismark.cov,cases,chr11,108093451,108093451,1.34328358208955,9,661,670
SRR25023301_1_val_1_bismark_bt2_pe.bismark.cov,cases,chr11,108093457,108093457,1.49476831091181,10,659,669
SRR25023301_1_val_1_bismark_bt2_pe.bismark.cov,cases,chr11,108093461,108093461,0.449775112443778,3,664,667
SRR25023301_1_val_1_bismark_bt2_pe.bismark.cov,cases,chr11,108093467,108093467,0.449775112443778,3,664,667
SRR25023301_1_val_1_bismark_bt2_pe.bismark.cov,cases,chr11,108093476,108093476,1.05421686746988,7,657,664
SRR25023301_1_val_1_bismark_bt2_pe.bismark.cov,cases,chr11,108093485,108093485,0.455235204855842,3,656,659
SRR25023301_1_val_1_bismark_bt2_pe.bismark.cov,cases,chr11,108093505,108093505,0.646203554119548,4,615,619
SRR25023301_1_val_1_bismark_bt2_pe.bismark.cov,cases,chr11,108093520,108093520,0.773694390715667,4,513,517
SRR25023301_1_val_1_bismark_bt2_pe.bismark.cov,cases,chr11,108093529,108093529,0.0,0,27,27
SRR25023301_1_val_1_bismark_bt2_pe.bismark.cov,cases,chr11,108093532,108093532,0.0,0,26,26
SRR25023301_1_val_1_bismark_bt2_pe.bismark.cov,cases,chr11,108093538,108093538,0.0,0,39,39
SRR25023301_1_val_1_bismark_bt2_pe.bismark.cov,cases,chr11,108093560,108093560,0.18796992481203,1,531,532
SRR25023301_1_val_1_bismark_bt2_pe.bismark.cov,cases,chr11,108093567,108093567,1.3986013986014,8,564,572
SRR25023301_1_val_1_bismark_bt2_pe.bismark.cov,cases,chr11,108093572,108093572,1.19047619047619,7,581,588
SRR25023301_1_val_1_bismark_bt2_pe.bismark.cov,cases,chr11,108093579,108093579,0.826446280991736,5,600,605
SRR25023301_1_val_1_bismark_bt2_pe.bismark.cov,cases,chr11,108093584,108093584,0.161030595813205,1,620,621
SRR25023301_1_val_1_bismark_bt2_pe.bismark.cov,cases,chr11,108093590,108093590,0.152905198776758,1,653,654
SRR25023301_1_val_1_bismark_bt2_pe.bismark.cov,cases,chr11,108093598,108093598,0.298953662182362,2,667,669
SRR25023301_1_val_1_bismark_bt2_pe.bismark.cov,cases,chr8,30890012,30890012,68.5106382978723,161,74,235
SRR25023301_1_val_1_bismark_bt2_pe.bismark.cov,cases,chr8,30890034,30890034,72.1030042918455,168,65,233
SRR25023301_1_val_1_bismark_bt2_pe.bismark.cov,cases,chr8,30890051,30890051,96.0869565217391,221,9,230
SRR25023301_1_val_1_bismark_bt2_pe.bismark.cov,cases,chr8,30890057,30890057,82.7586206896552,192,40,232
SRR25023301_1_val_1_bismark_bt2_pe.bismark.cov,cases,chr8,30890073,30890073,54.5064377682403,127,106,233
SRR25023301_1_val_1_bismark_bt2_pe.bismark.cov,cases,chr8,30890108,30890108,24.5689655172414,57,175,232
SRR25023301_1_val_1_bismark_bt2_pe.bismark.cov,cases,chr8,30890133,30890133,32.6086956521739,75,155,230
SRR25023301_1_val_1_bismark_bt2_pe.bismark.cov,cases,chr8,30890139,30890139,52.1739130434783,120,110,230
SRR25023301_1_val_1_bismark_bt2_pe.bismark.cov,cases,chr8,30890145,30890145,18.2608695652174,42,188,230
SRR25023301_1_val_1_bismark_bt2_pe.bismark.cov,cases,chr8,30890170,30890170,18.2608695652174,42,188,230
SRR25023301_1_val_1_bismark_bt2_pe.bismark.cov,cases,chr8,30890172,30890172,20.8695652173913,48,182,230
SRR25023301_1_val_1_bismark_bt2_pe.bismark.cov,cases,chr8,90997245,90997245,16.2790697674419,14,72,86
SRR25023301_1_val_1_bismark_bt2_pe.bismark.cov,cases,chr8,90997299,90997299,3.79746835443038,3,76,79
SRR25023301_1_val_1_bismark_bt2_pe.bismark.cov,cases,chr8,90997454,90997454,35.1351351351351,26,48,74
SRR25023301_1_val_1_bismark_bt2_pe.bismark.cov,cases,chr8,90997482,90997482,98.6111111111111,71,1,72
SRR25023301_1_val_1_bismark_bt2_pe.bismark.cov,cases,chr15,89786999,89786999,1.25786163522013,4,314,318
SRR25023301_1_val_1_bismark_bt2_pe.bismark.cov,cases,chr15,89787007,89787007,0.928792569659443,3,320,323
SRR25023301_1_val_1_bismark_bt2_pe.bismark.cov,cases,chr15,89787009,89787009,1.23456790123457,4,320,324
SRR25023301_1_val_1_bismark_bt2_pe.bismark.cov,cases,chr15,89787018,89787018,0.617283950617284,2,322,324
SRR25023301_1_val_1_bismark_bt2_pe.bismark.cov,cases,chr15,89787032,89787032,0.925925925925926,3,321,324
SRR25023301_1_val_1_bismark_bt2_pe.bismark.cov,cases,chr15,89787034,89787034,0.617283950617284,2,322,324
SRR25023301_1_val_1_bismark_bt2_pe.bismark.cov,cases,chr15,89787036,89787036,0.308641975308642,1,323,324
SRR25023301_1_val_1_bismark_bt2_pe.bismark.cov,cases,chr15,89787045,89787045,0.31055900621118,1,321,322
SRR25023301_1_val_1_bismark_bt2_pe.bismark.cov,cases,chr15,89787048,89787048,0.93167701863354,3,319,322
SRR25023301_1_val_1_bismark_bt2_pe.bismark.cov,cases,chr15,89787058,89787058,0.625,2,318,320
SRR25023301_1_val_1_bismark_bt2_pe.bismark.cov,cases,chr15,89787060,89787060,0.3125,1,319,320
SRR25023301_1_val_1_bismark_bt2_pe.bismark.cov,cases,chr15,89787066,89787066,0.626959247648903,2,317,319
SRR25023301_1_val_1_bismark_bt2_pe.bismark.cov,cases,chr15,89787077,89787077,0.0,0,318,318
SRR25023301_1_val_1_bismark_bt2_pe.bismark.cov,cases,chr15,89787087,89787087,0.313479623824451,1,318,319
SRR25023301_1_val_1_bismark_bt2_pe.bismark.cov,cases,chr15,89787103,89787103,0.638977635782748,2,311,313
SRR25023301_1_val_1_bismark_bt2_pe.bismark.cov,cases,chr15,89787109,89787109,0.641025641025641,2,310,312
SRR25023301_1_val_1_bismark_bt2_pe.bismark.cov,cases,chr15,89787113,89787113,0.964630225080386,3,308,311
SRR25023301_1_val_1_bismark_bt2_pe.bismark.cov,cases,chr15,89787120,89787120,0.964630225080386,3,308,311
SRR25023301_1_val_1_bismark_bt2_pe.bismark.cov,cases,chr15,89787150,89787150,0.649350649350649,2,306,308
SRR25023301_1_val_1_bismark_bt2_pe.bismark.cov,cases,chr15,89787154,89787154,0.651465798045603,2,305,307
SRR25023301_1_val_1_bismark_bt2_pe.bismark.cov,cases,chr15,89787164,89787164,0.327868852459016,1,304,305
SRR25023301_1_val_1_bismark_bt2_pe.bismark.cov,cases,chr15,89787168,89787168,0.0,0,307,307
SRR25023301_1_val_1_bismark_bt2_pe.bismark.cov,cases,chr15,89787171,89787171,0.65359477124183,2,304,306
SRR25023301_1_val_1_bismark_bt2_pe.bismark.cov,cases,chr15,89787182,89787182,1.98019801980198,6,297,303
SRR25023301_1_val_1_bismark_bt2_pe.bismark.cov,cases,chr15,89787184,89787184,0.0,0,301,301
SRR25023301_1_val_1_bismark_bt2_pe.bismark.cov,cases,chr15,89787190,89787190,0.0,0,298,298
SRR25023301_1_val_1_bismark_bt2_pe.bismark.cov,cases,chr15,89787205,89787205,0.0,0,281,281
SRR25023301_1_val_1_bismark_bt2_pe.bismark.cov,cases,chr15,89787212,89787212,0.900900900900901,2,220,222
SRR25023301_1_val_1_bismark_bt2_pe.bismark.cov,cases,chr15,89787223,89787223,1.06951871657754,2,185,187
SRR25023301_1_val_1_bismark_bt2_pe.bismark.cov,cases,chr15,89787226,89787226,0.531914893617021,1,187,188
SRR25023301_1_val_1_bismark_bt2_pe.bismark.cov,cases,chr15,89787238,89787238,1.41509433962264,3,209,212
SRR25023301_1_val_1_bismark_bt2_pe.bismark.cov,cases,chr15,89787260,89787260,1.71673819742489,4,229,233
SRR25023301_1_val_1_bismark_bt2_pe.bismark.cov,cases,chr15,89787272,89787272,1.68067226890756,4,234,238
SRR25023301_1_val_1_bismark_bt2_pe.bismark.cov,cases,chr15,89787288,89787288,1.77304964539007,5,277,282
SRR25023301_1_val_1_bismark_bt2_pe.bismark.cov,cases,chr15,89787293,89787293,0.0,0,292,292
SRR25023301_1_val_1_bismark_bt2_pe.bismark.cov,cases,chr15,89787295,89787295,0.341296928327645,1,292,293
SRR25023301_1_val_1_bismark_bt2_pe.bismark.cov,cases,chr15,89787304,89787304,0.325732899022801,1,306,307
SRR25023301_1_val_1_bismark_bt2_pe.bismark.cov,cases,chr15,89787335,89787335,0.625,2,318,320
SRR25023301_1_val_1_bismark_bt2_pe.bismark.cov,cases,chr17,41277106,41277106,0.963000506842372,19,1954,1973
SRR25023301_1_val_1_bismark_bt2_pe.bismark.cov,cases,chr17,41277115,41277115,0.861195542046606,17,1957,1974
SRR25023301_1_val_1_bismark_bt2_pe.bismark.cov,cases,chr17,41277117,41277117,0.760263558033452,15,1958,1973
SRR25023301_1_val_1_bismark_bt2_pe.bismark.cov,cases,chr17,41277153,41277153,0.813008130081301,16,1952,1968
SRR25023301_1_val_1_bismark_bt2_pe.bismark.cov,cases,chr17,41277160,41277160,0.60882800608828,12,1959,1971
SRR25023301_1_val_1_bismark_bt2_pe.bismark.cov,cases,chr17,41277174,41277174,1.47133434804668,29,1942,1971
SRR25023301_1_val_1_bismark_bt2_pe.bismark.cov,cases,chr17,41277187,41277187,7.57128810226155,77,940,1017
SRR25023301_1_val_1_bismark_bt2_pe.bismark.cov,cases,chr17,41277214,41277214,0.958144225920323,19,1964,1983
SRR25023301_1_val_1_bismark_bt2_pe.bismark.cov,cases,chr17,41277232,41277232,0.654911838790932,13,1972,1985
SRR25023301_1_val_1_bismark_bt2_pe.bismark.cov,cases,chr17,56769746,56769746,83.0188679245283,132,27,159
SRR25023301_1_val_1_bismark_bt2_pe.bismark.cov,cases,chr17,56769760,56769760,84.9056603773585,135,24,159
SRR25023301_1_val_1_bismark_bt2_pe.bismark.cov,cases,chr17,56769767,56769767,70.0636942675159,110,47,157
SRR25023301_1_val_1_bismark_bt2_pe.bismark.cov,cases,chr17,56769830,56769830,0.641025641025641,1,155,156
SRR25023301_1_val_1_bismark_bt2_pe.bismark.cov,cases,chr17,56769866,56769866,1.29032258064516,2,153,155
SRR25023301_1_val_1_bismark_bt2_pe.bismark.cov,cases,chr17,56769883,56769883,0.0,0,153,153
SRR25023301_1_val_1_bismark_bt2_pe.bismark.cov,cases,chr17,56769891,56769891,0.65359477124183,1,152,153
SRR25023301_1_val_1_bismark_bt2_pe.bismark.cov,cases,chr17,56769895,56769895,0.0,0,152,152
SRR25023301_1_val_1_bismark_bt2_pe.bismark.cov,cases,chr17,56769904,56769904,0.0,0,152,152
SRR25023301_1_val_1_bismark_bt2_pe.bismark.cov,cases,chr17,56769912,56769912,1.31578947368421,2,150,152
SRR25023301_1_val_1_bismark_bt2_pe.bismark.cov,cases,chr17,56769922,56769922,1.32450331125828,2,149,151
SRR25023301_1_val_1_bismark_bt2_pe.bismark.cov,cases,chr17,56769929,56769929,0.0,0,151,151
SRR25023301_1_val_1_bismark_bt2_pe.bismark.cov,cases,chr17,56769936,56769936,0.0,0,151,151
SRR25023301_1_val_1_bismark_bt2_pe.bismark.cov,cases,chr17,56769941,56769941,0.0,0,151,151
SRR25023301_1_val_1_bismark_bt2_pe.bismark.cov,cases,chr17,56769944,56769944,0.666666666666667,1,149,150
SRR25023301_1_val_1_bismark_bt2_pe.bismark.cov,cases,chr17,56769948,56769948,0.675675675675676,1,147,148
SRR25023301_1_val_1_bismark_bt2_pe.bismark.cov,cases,chr17,56769956,56769956,0.719424460431655,1,138,139
SRR25023301_1_val_1_bismark_bt2_pe.bismark.cov,cases,chr17,56769962,56769962,0.75187969924812,1,132,133
SRR25023301_1_val_1_bismark_bt2_pe.bismark.cov,cases,chr17,56769966,56769966,0.769230769230769,1,129,130
SRR25023301_1_val_1_bismark_bt2_pe.bismark.cov,cases,chr17,56769982,56769982,0.740740740740741,1,134,135
SRR25023301_1_val_1_bismark_bt2_pe.bismark.cov,cases,chr17,56770003,56770003,0.0,0,145,145
SRR25023301_1_val_1_bismark_bt2_pe.bismark.cov,cases,chr17,56770008,56770008,0.684931506849315,1,145,146
SRR25023301_1_val_1_bismark_bt2_pe.bismark.cov,cases,chr17,56770010,56770010,1.36986301369863,2,144,146
SRR25023301_1_val_1_bismark_bt2_pe.bismark.cov,cases,chr17,56770018,56770018,0.0,0,146,146
SRR25023301_1_val_1_bismark_bt2_pe.bismark.cov,cases,chr17,56770023,56770023,1.36986301369863,2,144,146
SRR25023301_1_val_1_bismark_bt2_pe.bismark.cov,cases,chr17,56770038,56770038,2.04081632653061,3,144,147
SRR25023301_1_val_1_bismark_bt2_pe.bismark.cov,cases,chr17,56770057,56770057,0.666666666666667,1,149,150
SRR25023301_1_val_1_bismark_bt2_pe.bismark.cov,cases,chr17,56770069,56770069,1.98675496688742,3,148,151
SRR25023301_1_val_1_bismark_bt2_pe.bismark.cov,cases,chr17,56770074,56770074,0.662251655629139,1,150,151
SRR25023301_1_val_1_bismark_bt2_pe.bismark.cov,cases,chr17,56770093,56770093,0.0,0,151,151
SRR25023301_1_val_1_bismark_bt2_pe.bismark.cov,cases,chr17,59940970,59940970,0.429184549356223,2,464,466
SRR25023301_1_val_1_bismark_bt2_pe.bismark.cov,cases,chr17,59940975,59940975,0.21505376344086,1,464,465
SRR25023301_1_val_1_bismark_bt2_pe.bismark.cov,cases,chr17,59940988,59940988,0.216450216450216,1,461,462
SRR25023301_1_val_1_bismark_bt2_pe.bismark.cov,cases,chr17,59940997,59940997,0.442477876106195,2,450,452
SRR25023301_1_val_1_bismark_bt2_pe.bismark.cov,cases,chr17,59941017,59941017,0.0,0,261,261
SRR25023301_1_val_1_bismark_bt2_pe.bismark.cov,cases,chr17,59941051,59941051,0.216919739696312,1,460,461
SRR25023301_1_val_1_bismark_bt2_pe.bismark.cov,cases,chr17,59941053,59941053,2.19123505976096,11,491,502
SRR25023301_1_val_1_bismark_bt2_pe.bismark.cov,cases,chr17,59941056,59941056,0.435729847494553,2,457,459
SRR25023301_1_val_1_bismark_bt2_pe.bismark.cov,cases,chr17,59941067,59941067,0.212765957446809,1,469,470
SRR25023301_1_val_1_bismark_bt2_pe.bismark.cov,cases,chr17,59941110,59941110,0.190114068441065,1,525,526
SRR25023301_1_val_1_bismark_bt2_pe.bismark.cov,cases,chr17,59941133,59941133,0.568181818181818,3,525,528
SRR25023301_1_val_1_bismark_bt2_pe.bismark.cov,cases,chr17,59941136,59941136,0.760456273764259,4,522,526
SRR25023301_1_val_1_bismark_bt2_pe.bismark.cov,cases,chr17,59941187,59941187,0.378787878787879,2,526,528
SRR25023301_1_val_1_bismark_bt2_pe.bismark.cov,cases,chr17,59941191,59941191,0.378071833648393,2,527,529
SRR25023301_1_val_1_bismark_bt2_pe.bismark.cov,cases,chr17,59941201,59941201,1.51133501259446,6,391,397
SRR25023301_1_val_1_bismark_bt2_pe.bismark.cov,cases,chr17,59941202,59941202,0.0,0,116,116
SRR25023301_1_val_1_bismark_bt2_pe.bismark.cov,cases,chr17,76325846,76325846,48.5714285714286,17,18,35
SRR25023301_1_val_1_bismark_bt2_pe.bismark.cov,cases,chr17,76325851,76325851,25.7142857142857,9,26,35
SRR25023301_1_val_1_bismark_bt2_pe.bismark.cov,cases,chr17,76325865,76325865,17.1428571428571,6,29,35
SRR25023301_1_val_1_bismark_bt2_pe.bismark.cov,cases,chr17,76325979,76325979,82.8571428571429,29,6,35
SRR25023301_1_val_1_bismark_bt2_pe.bismark.cov,cases,chr16,23652769,23652769,0.603621730382294,3,494,497
SRR25023301_1_val_1_bismark_bt2_pe.bismark.cov,cases,chr16,23652783,23652783,0.402414486921529,2,495,497
SRR25023301_1_val_1_bismark_bt2_pe.bismark.cov,cases,chr16,23652787,23652787,1.0,5,495,500
SRR25023301_1_val_1_bismark_bt2_pe.bismark.cov,cases,chr16,23652797,23652797,0.403225806451613,2,494,496
SRR25023301_1_val_1_bismark_bt2_pe.bismark.cov,cases,chr16,23652818,23652818,0.612244897959184,3,487,490
SRR25023301_1_val_1_bismark_bt2_pe.bismark.cov,cases,chr16,23652838,23652838,0.204498977505113,1,488,489
SRR25023301_1_val_1_bismark_bt2_pe.bismark.cov,cases,chr16,23652857,23652857,0.0,0,505,505
SRR25023301_1_val_1_bismark_bt2_pe.bismark.cov,cases,chr16,23652860,23652860,0.198412698412698,1,503,504
SRR25023301_1_val_1_bismark_bt2_pe.bismark.cov,cases,chr16,23652876,23652876,0.99009900990099,5,500,505
SRR25023301_1_val_1_bismark_bt2_pe.bismark.cov,cases,chr16,23652906,23652906,0.596421471172962,3,500,503
SRR25023301_1_val_1_bismark_bt2_pe.bismark.cov,cases,chr16,23652911,23652911,1.78926441351889,9,494,503
SRR25023301_1_val_1_bismark_bt2_pe.bismark.cov,cases,chr16,23652916,23652916,1.01214574898785,5,489,494
SRR25023301_1_val_1_bismark_bt2_pe.bismark.cov,cases,chr16,23652918,23652918,1.39442231075697,7,495,502
SRR25023301_1_val_1_bismark_bt2_pe.bismark.cov,cases,chr6,43543548,43543548,0.0,0,112,112
SRR25023301_1_val_1_bismark_bt2_pe.bismark.cov,cases,chr6,43543554,43543554,0.0,0,112,112
SRR25023301_1_val_1_bismark_bt2_pe.bismark.cov,cases,chr6,43543571,43543571,0.0,0,111,111
SRR25023301_1_val_1_bismark_bt2_pe.bismark.cov,cases,chr6,43543578,43543578,0.900900900900901,1,110,111
SRR25023301_1_val_1_bismark_bt2_pe.bismark.cov,cases,chr6,43543580,43543580,0.0,0,111,111
SRR25023301_1_val_1_bismark_bt2_pe.bismark.cov,cases,chr6,43543596,43543596,0.900900900900901,1,110,111
SRR25023301_1_val_1_bismark_bt2_pe.bismark.cov,cases,chr6,43543608,43543608,0.0,0,110,110
SRR25023301_1_val_1_bismark_bt2_pe.bismark.cov,cases,chr6,43543613,43543613,0.0,0,111,111
SRR25023301_1_val_1_bismark_bt2_pe.bismark.cov,cases,chr6,43543615,43543615,0.0,0,111,111
SRR25023301_1_val_1_bismark_bt2_pe.bismark.cov,cases,chr6,43543618,43543618,0.0,0,111,111
SRR25023301_1_val_1_bismark_bt2_pe.bismark.cov,cases,chr6,43543624,43543624,0.900900900900901,1,110,111
SRR25023301_1_val_1_bismark_bt2_pe.bismark.cov,cases,chr6,43543642,43543642,0.900900900900901,1,110,111
SRR25023301_1_val_1_bismark_bt2_pe.bismark.cov,cases,chr6,43543650,43543650,0.0,0,111,111
SRR25023301_1_val_1_bismark_bt2_pe.bismark.cov,cases,chr6,43543657,43543657,0.900900900900901,1,110,111
SRR25023301_1_val_1_bismark_bt2_pe.bismark.cov,cases,chr6,43543669,43543669,0.892857142857143,1,111,112
SRR25023301_1_val_1_bismark_bt2_pe.bismark.cov,cases,chr6,43543672,43543672,0.0,0,111,111
SRR25023301_1_val_1_bismark_bt2_pe.bismark.cov,cases,chr6,43543682,43543682,1.8348623853211,2,107,109
SRR25023301_1_val_1_bismark_bt2_pe.bismark.cov,cases,chr6,43543691,43543691,0.0,0,108,108
SRR25023301_1_val_1_bismark_bt2_pe.bismark.cov,cases,chr6,43543696,43543696,6.42201834862385,7,102,109
SRR25023301_1_val_1_bismark_bt2_pe.bismark.cov,cases,chr6,43543698,43543698,0.0,0,108,108
SRR25023301_1_val_1_bismark_bt2_pe.bismark.cov,cases,chr6,43543701,43543701,1.81818181818182,2,108,110
SRR25023301_1_val_1_bismark_bt2_pe.bismark.cov,cases,chr6,43543705,43543705,0.0,0,111,111
SRR25023301_1_val_1_bismark_bt2_pe.bismark.cov,cases,chr6,43543708,43543708,0.0,0,111,111
SRR25023301_1_val_1_bismark_bt2_pe.bismark.cov,cases,chr6,43543733,43543733,2.77777777777778,3,105,108
SRR25023301_1_val_1_bismark_bt2_pe.bismark.cov,cases,chr6,43543747,43543747,0.925925925925926,1,107,108
SRR25023301_1_val_1_bismark_bt2_pe.bismark.cov,cases,chr6,43543749,43543749,0.0,0,108,108
SRR25023301_1_val_1_bismark_bt2_pe.bismark.cov,cases,chr6,43543763,43543763,0.0,0,107,107
SRR25023301_1_val_1_bismark_bt2_pe.bismark.cov,cases,chr6,43543766,43543766,0.934579439252336,1,106,107
SRR25023301_1_val_1_bismark_bt2_pe.bismark.cov,cases,chr6,43543771,43543771,0.0,0,110,110
SRR25023301_1_val_1_bismark_bt2_pe.bismark.cov,cases,chr6,43543775,43543775,0.0,0,106,106
SRR25023301_1_val_1_bismark_bt2_pe.bismark.cov,cases,chr6,43543777,43543777,2.85714285714286,3,102,105
SRR25023301_1_val_1_bismark_bt2_pe.bismark.cov,cases,chr6,43543781,43543781,0.0,0,107,107
SRR25023301_1_val_1_bismark_bt2_pe.bismark.cov,cases,chr6,43543786,43543786,0.934579439252336,1,106,107
SRR25023301_1_val_1_bismark_bt2_pe.bismark.cov,cases,chr6,43543794,43543794,0.0,0,109,109
SRR25023301_1_val_1_bismark_bt2_pe.bismark.cov,cases,chr6,43543798,43543798,0.0,0,109,109
SRR25023301_1_val_1_bismark_bt2_pe.bismark.cov,cases,chr6,43543800,43543800,0.0,0,109,109
SRR25023301_1_val_1_bismark_bt2_pe.bismark.cov,cases,chr6,43543804,43543804,0.925925925925926,1,107,108
SRR25023301_1_val_1_bismark_bt2_pe.bismark.cov,cases,chr6,43543806,43543806,1.85185185185185,2,106,108
SRR25023301_1_val_1_bismark_bt2_pe.bismark.cov,cases,chr6,43543815,43543815,1.81818181818182,2,108,110
SRR25023301_1_val_1_bismark_bt2_pe.bismark.cov,cases,chr6,43543822,43543822,0.0,0,111,111
SRR25023301_1_val_1_bismark_bt2_pe.bismark.cov,cases,chr7,6048869,6048869,0.504484304932735,18,3550,3568
SRR25023301_1_val_1_bismark_bt2_pe.bismark.cov,cases,chr7,6048876,6048876,0.702049985959,25,3536,3561
SRR25023301_1_val_1_bismark_bt2_pe.bismark.cov,cases,chr7,6048884,6048884,0.897615708274895,32,3533,3565
SRR25023301_1_val_1_bismark_bt2_pe.bismark.cov,cases,chr7,6048888,6048888,0.562271577171774,20,3537,3557
SRR25023301_1_val_1_bismark_bt2_pe.bismark.cov,cases,chr7,6048892,6048892,0.815523059617548,29,3527,3556
SRR25023301_1_val_1_bismark_bt2_pe.bismark.cov,cases,chr7,6048904,6048904,0.0,0,724,724
SRR25023301_1_val_1_bismark_bt2_pe.bismark.cov,cases,chr7,6048918,6048918,0.252808988764045,9,3551,3560
SRR25023301_1_val_1_bismark_bt2_pe.bismark.cov,cases,chr7,6048925,6048925,0.336700336700337,12,3552,3564
SRR25023301_1_val_1_bismark_bt2_pe.bismark.cov,cases,chr7,6048928,6048928,0.588895120583287,21,3545,3566
SRR25023301_1_val_1_bismark_bt2_pe.bismark.cov,cases,chr7,6048940,6048940,0.952647800504343,34,3535,3569
SRR25023301_1_val_1_bismark_bt2_pe.bismark.cov,cases,chr7,6048951,6048951,0.5890603085554,21,3544,3565
SRR25023301_1_val_1_bismark_bt2_pe.bismark.cov,cases,chr7,6048966,6048966,0.448681996634885,16,3550,3566
SRR25023301_1_val_1_bismark_bt2_pe.bismark.cov,cases,chr7,6048968,6048968,0.58972198820556,21,3540,3561
SRR25023301_1_val_1_bismark_bt2_pe.bismark.cov,cases,chr22,29137950,29137950,1.49253731343284,1,66,67
SRR25023301_1_val_1_bismark_bt2_pe.bismark.cov,cases,chr22,29137964,29137964,0.0,0,60,60
SRR25023301_1_val_1_bismark_bt2_pe.bismark.cov,cases,chr22,29137975,29137975,0.0,0,54,54
SRR25023301_1_val_1_bismark_bt2_pe.bismark.cov,cases,chr22,29137985,29137985,0.0,0,41,41
SRR25023301_1_val_1_bismark_bt2_pe.bismark.cov,cases,chr22,29137993,29137993,0.0,0,32,32
SRR25023301_1_val_1_bismark_bt2_pe.bismark.cov,cases,chr22,29138031,29138031,0.0,0,60,60
SRR25023301_1_val_1_bismark_bt2_pe.bismark.cov,cases,chr22,29138052,29138052,0.0,0,61,61
SRR25023301_1_val_1_bismark_bt2_pe.bismark.cov,cases,chr22,29138062,29138062,0.0,0,63,63
SRR25023301_1_val_1_bismark_bt2_pe.bismark.cov,cases,chr22,29138075,29138075,0.0,0,64,64
SRR25023301_1_val_1_bismark_bt2_pe.bismark.cov,cases,chr22,29138078,29138078,0.0,0,64,64
SRR25023301_1_val_1_bismark_bt2_pe.bismark.cov,cases,chr22,29138091,29138091,0.0,0,59,59
SRR25023301_1_val_1_bismark_bt2_pe.bismark.cov,cases,chr22,29138102,29138102,0.0,0,63,63
SRR25023301_1_val_1_bismark_bt2_pe.bismark.cov,cases,chr22,29138115,29138115,0.0,0,62,62
SRR25023301_1_val_1_bismark_bt2_pe.bismark.cov,cases,chr22,29138134,29138134,0.0,0,64,64
SRR25023301_1_val_1_bismark_bt2_pe.bismark.cov,cases,chr22,29138158,29138158,0.0,0,66,66
SRR25023301_1_val_1_bismark_bt2_pe.bismark.cov,cases,chr22,29138168,29138168,0.0,0,66,66
SRR25023301_1_val_1_bismark_bt2_pe.bismark.cov,cases,chr22,29138176,29138176,0.0,0,67,67
SRR25023301_1_val_1_bismark_bt2_pe.bismark.cov,cases,chr22,29138179,29138179,0.0,0,67,67
SRR25023301_1_val_1_bismark_bt2_pe.bismark.cov,cases,chr22,29138185,29138185,1.49253731343284,1,66,67
SRR25023301_1_val_1_bismark_bt2_pe.bismark.cov,cases,chr22,29138202,29138202,0.0,0,67,67
SRR25023301_1_val_1_bismark_bt2_pe.bismark.cov,cases,chr22,29138216,29138216,0.0,0,68,68
SRR25023301_1_val_1_bismark_bt2_pe.bismark.cov,cases,chr22,29138219,29138219,0.0,0,68,68
SRR25023301_1_val_1_bismark_bt2_pe.bismark.cov,cases,chr22,29138234,29138234,0.0,0,68,68
SRR25023301_1_val_1_bismark_bt2_pe.bismark.cov,cases,chr22,29138238,29138238,0.0,0,68,68
SRR25023301_1_val_1_bismark_bt2_pe.bismark.cov,cases,chrX,14891454,14891454,34.8928463628132,1156,2157,3313
SRR25023301_1_val_1_bismark_bt2_pe.bismark.cov,cases,chrX,14891470,14891470,24.6218995765275,814,2492,3306
SRR25023301_1_val_1_bismark_bt2_pe.bismark.cov,cases,chrX,14891474,14891474,34.3712212817412,1137,2171,3308
SRR25023301_1_val_1_bismark_bt2_pe.bismark.cov,cases,chrX,14891488,14891488,29.0887145443573,964,2350,3314
SRR25023301_1_val_1_bismark_bt2_pe.bismark.cov,cases,chrX,14891493,14891493,45.8220211161388,1519,1796,3315
SRR25023301_1_val_1_bismark_bt2_pe.bismark.cov,cases,chrX,14891496,14891496,39.4387447193724,1307,2007,3314
SRR25023301_1_val_1_bismark_bt2_pe.bismark.cov,cases,chrX,14891499,14891499,30.4977375565611,1011,2304,3315
SRR25023301_1_val_1_bismark_bt2_pe.bismark.cov,cases,chrX,14891509,14891509,43.1248111211846,1427,1882,3309
SRR25023301_1_val_1_bismark_bt2_pe.bismark.cov,cases,chrX,14891516,14891516,45.7376058041112,1513,1795,3308
SRR25023301_1_val_1_bismark_bt2_pe.bismark.cov,cases,chrX,14891524,14891524,33.5550181378476,1110,2198,3308
SRR25023301_1_val_1_bismark_bt2_pe.bismark.cov,cases,chrX,14891526,14891526,36.0749924402782,1193,2114,3307
SRR25023301_1_val_1_bismark_bt2_pe.bismark.cov,cases,chrX,14891530,14891530,40.3747355696585,1336,1973,3309
SRR25023302_1_val_1_bismark_bt2_pe.bismark.cov,cases,chr3,37034307,37034307,99.9356499356499,3106,2,3108
SRR25023302_1_val_1_bismark_bt2_pe.bismark.cov,cases,chr3,37034316,37034316,0.0642880102860816,2,3109,3111
SRR25023302_1_val_1_bismark_bt2_pe.bismark.cov,cases,chr3,37034324,37034324,0.160720025715204,5,3106,3111
SRR25023302_1_val_1_bismark_bt2_pe.bismark.cov,cases,chr3,37034330,37034330,0.224791265253693,7,3107,3114
SRR25023302_1_val_1_bismark_bt2_pe.bismark.cov,cases,chr3,37034344,37034344,0.48185030517186,15,3098,3113
SRR25023302_1_val_1_bismark_bt2_pe.bismark.cov,cases,chr3,37034346,37034346,0.514634930845931,16,3093,3109
SRR25023302_1_val_1_bismark_bt2_pe.bismark.cov,cases,chr3,37034348,37034348,0.997425997425997,31,3077,3108
SRR25023302_1_val_1_bismark_bt2_pe.bismark.cov,cases,chr3,37034352,37034352,0.51413881748072,16,3096,3112
SRR25023302_1_val_1_bismark_bt2_pe.bismark.cov,cases,chr3,37034355,37034355,0.28892455858748,9,3106,3115
SRR25023302_1_val_1_bismark_bt2_pe.bismark.cov,cases,chr3,37034359,37034359,0.610343719884356,19,3094,3113
SRR25023302_1_val_1_bismark_bt2_pe.bismark.cov,cases,chr3,37034369,37034369,0.91533180778032,28,3031,3059
SRR25023302_1_val_1_bismark_bt2_pe.bismark.cov,cases,chr3,37034373,37034373,0.513643659711075,16,3099,3115
SRR25023302_1_val_1_bismark_bt2_pe.bismark.cov,cases,chr3,37034382,37034382,0.352451137455944,11,3110,3121
SRR25023302_1_val_1_bismark_bt2_pe.bismark.cov,cases,chr3,37034394,37034394,0.544348382965098,17,3106,3123
SRR25023302_1_val_1_bismark_bt2_pe.bismark.cov,cases,chr3,37034402,37034402,0.545221295702373,17,3101,3118
SRR25023302_1_val_1_bismark_bt2_pe.bismark.cov,cases,chr3,37034409,37034409,0.352225424271534,11,3112,3123
SRR25023302_1_val_1_bismark_bt2_pe.bismark.cov,cases,chr3,37034412,37034412,0.51249199231262,16,3106,3122
SRR25023302_1_val_1_bismark_bt2_pe.bismark.cov,cases,chr3,37034414,37034414,0.673940949935815,21,3095,3116
SRR25023302_1_val_1_bismark_bt2_pe.bismark.cov,cases,chr3,37034418,37034418,0.706260032102729,22,3093,3115
SRR25023302_1_val_1_bismark_bt2_pe.bismark.cov,cases,chr3,37034420,37034420,0.288831835686778,9,3107,3116
SRR25023302_1_val_1_bismark_bt2_pe.bismark.cov,cases,chr3,37034430,37034430,0.288646568313021,9,3109,3118
SRR25023302_1_val_1_bismark_bt2_pe.bismark.cov,cases,chr3,37034438,37034438,0.192184497117233,6,3116,3122
SRR25023302_1_val_1_bismark_bt2_pe.bismark.cov,cases,chr3,37034441,37034441,0.288554023725553,9,3110,3119
SRR25023302_1_val_1_bismark_bt2_pe.bismark.cov,cases,chr3,37034466,37034466,100.0,3113,0,3113
SRR25023302_1_val_1_bismark_bt2_pe.bismark.cov,cases,chr3,37034997,37034997,0.797101449275362,33,4107,4140
SRR25023302_1_val_1_bismark_bt2_pe.bismark.cov,cases,chr3,37035012,37035012,0.0724462690171456,3,4138,4141
SRR25023302_1_val_1_bismark_bt2_pe.bismark.cov,cases,chr3,37035032,37035032,0.507246376811594,21,4119,4140
SRR25023302_1_val_1_bismark_bt2_pe.bismark.cov,cases,chr3,37035043,37035043,0.289645184648805,12,4131,4143
SRR25023302_1_val_1_bismark_bt2_pe.bismark.cov,cases,chr3,37035047,37035047,0.41023166023166,17,4127,4144
SRR25023302_1_val_1_bismark_bt2_pe.bismark.cov,cases,chr3,37035063,37035063,0.675186882083434,28,4119,4147
SRR25023302_1_val_1_bismark_bt2_pe.bismark.cov,cases,chr3,37035066,37035066,0.337512054001929,14,4134,4148
SRR25023302_1_val_1_bismark_bt2_pe.bismark.cov,cases,chr3,37035074,37035074,0.314389359129383,13,4122,4135
SRR25023302_1_val_1_bismark_bt2_pe.bismark.cov,cases,chr3,37035090,37035090,1.01400289715113,42,4100,4142
SRR25023302_1_val_1_bismark_bt2_pe.bismark.cov,cases,chr3,37035095,37035095,1.18243243243243,49,4095,4144
SRR25023302_1_val_1_bismark_bt2_pe.bismark.cov,cases,chr3,37035097,37035097,0.506634499396864,21,4124,4145
SRR25023302_1_val_1_bismark_bt2_pe.bismark.cov,cases,chr3,37035100,37035100,0.169082125603865,7,4133,4140
SRR25023302_1_val_1_bismark_bt2_pe.bismark.cov,cases,chr3,37035117,37035117,0.700652331481034,29,4110,4139
SRR25023302_1_val_1_bismark_bt2_pe.bismark.cov,cases,chr3,142297977,142297977,0.578778135048232,9,1546,1555
SRR25023302_1_val_1_bismark_bt2_pe.bismark.cov,cases,chr3,142298019,142298019,0.900900900900901,14,1540,1554
SRR25023302_1_val_1_bismark_bt2_pe.bismark.cov,cases,chr3,142298045,142298045,0.900900900900901,14,1540,1554
SRR25023302_1_val_1_bismark_bt2_pe.bismark.cov,cases,chr3,142298054,142298054,3.99742101869761,62,1489,1551
SRR25023302_1_val_1_bismark_bt2_pe.bismark.cov,cases,chr13,32889392,32889392,20.3631647211414,785,3070,3855
SRR25023302_1_val_1_bismark_bt2_pe.bismark.cov,cases,chr13,32889434,32889434,2.23434658352819,86,3763,3849
SRR25023302_1_val_1_bismark_bt2_pe.bismark.cov,cases,chr13,32889461,32889461,0.677083333333333,26,3814,3840
SRR25023302_1_val_1_bismark_bt2_pe.bismark.cov,cases,chr13,32889470,32889470,0.389914218871848,15,3832,3847
SRR25023302_1_val_1_bismark_bt2_pe.bismark.cov,cases,chr13,32889484,32889484,0.363919937613725,14,3833,3847
SRR25023302_1_val_1_bismark_bt2_pe.bismark.cov,cases,chr13,108867034,108867034,41.3863404689093,406,575,981
SRR25023302_1_val_1_bismark_bt2_pe.bismark.cov,cases,chr13,108867044,108867044,47.3,473,527,1000
SRR25023302_1_val_1_bismark_bt2_pe.bismark.cov,cases,chr13,108867051,108867051,39.5791583166333,395,603,998
SRR25023302_1_val_1_bismark_bt2_pe.bismark.cov,cases,chr13,108867109,108867109,51.4910536779324,518,488,1006
SRR25023302_1_val_1_bismark_bt2_pe.bismark.cov,cases,chr13,108867112,108867112,58.051689860835,584,422,1006
SRR25023302_1_val_1_bismark_bt2_pe.bismark.cov,cases,chr13,108867124,108867124,46.8127490039841,470,534,1004
SRR25023302_1_val_1_bismark_bt2_pe.bismark.cov,cases,chr13,108867135,108867135,34.2629482071713,344,660,1004
SRR25023302_1_val_1_bismark_bt2_pe.bismark.cov,cases,chr13,108867155,108867155,33.8677354709419,338,660,998
SRR25023302_1_val_1_bismark_bt2_pe.bismark.cov,cases,chr2,47596828,47596828,3.81054131054131,107,2701,2808
SRR25023302_1_val_1_bismark_bt2_pe.bismark.cov,cases,chr2,47596830,47596830,4.28370786516854,122,2726,2848
SRR25023302_1_val_1_bismark_bt2_pe.bismark.cov,cases,chr2,47596840,47596840,5.32026601330067,152,2705,2857
SRR25023302_1_val_1_bismark_bt2_pe.bismark.cov,cases,chr2,47596849,47596849,20.7896575821104,595,2267,2862
SRR25023302_1_val_1_bismark_bt2_pe.bismark.cov,cases,chr2,47596853,47596853,6.85314685314685,196,2664,2860
SRR25023302_1_val_1_bismark_bt2_pe.bismark.cov,cases,chr2,47596858,47596858,11.3676110528157,325,2534,2859
SRR25023302_1_val_1_bismark_bt2_pe.bismark.cov,cases,chr2,47596862,47596862,9.50716532680881,272,2589,2861
SRR25023302_1_val_1_bismark_bt2_pe.bismark.cov,cases,chr2,47596869,47596869,20.0069832402235,573,2291,2864
SRR25023302_1_val_1_bismark_bt2_pe.bismark.cov,cases,chr2,47596883,47596883,14.9859943977591,428,2428,2856
SRR25023302_1_val_1_bismark_bt2_pe.bismark.cov,cases,chr2,47596885,47596885,4.83193277310924,138,2718,2856
SRR25023302_1_val_1_bismark_bt2_pe.bismark.cov,cases,chr2,47596887,47596887,8.47042352117606,242,2615,2857
SRR25023302_1_val_1_bismark_bt2_pe.bismark.cov,cases,chr2,47596897,47596897,6.79033951697585,194,2663,2857
SRR25023302_1_val_1_bismark_bt2_pe.bismark.cov,cases,chr2,47596900,47596900,4.6584938704028,133,2722,2855
SRR25023302_1_val_1_bismark_bt2_pe.bismark.cov,cases,chr2,47596907,47596907,3.50385423966363,100,2754,2854
SRR25023302_1_val_1_bismark_bt2_pe.bismark.cov,cases,chr2,47596912,47596912,2.24246671338472,64,2790,2854
SRR25023302_1_val_1_bismark_bt2_pe.bismark.cov,cases,chr2,47596930,47596930,6.53617616218106,187,2674,2861
SRR25023302_1_val_1_bismark_bt2_pe.bismark.cov,cases,chr2,47596942,47596942,6.78321678321678,194,2666,2860
SRR25023302_1_val_1_bismark_bt2_pe.bismark.cov,cases,chr2,47630224,47630224,0.937709310113865,14,1479,1493
SRR25023302_1_val_1_bismark_bt2_pe.bismark.cov,cases,chr2,47630227,47630227,0.851342501637197,13,1514,1527
SRR25023302_1_val_1_bismark_bt2_pe.bismark.cov,cases,chr2,47630233,47630233,0.0,0,1528,1528
SRR25023302_1_val_1_bismark_bt2_pe.bismark.cov,cases,chr2,47630237,47630237,0.327225130890052,5,1523,1528
SRR25023302_1_val_1_bismark_bt2_pe.bismark.cov,cases,chr2,47630240,47630240,0.589005235602094,9,1519,1528
SRR25023302_1_val_1_bismark_bt2_pe.bismark.cov,cases,chr2,47630244,47630244,0.654878847413229,10,1517,1527
SRR25023302_1_val_1_bismark_bt2_pe.bismark.cov,cases,chr2,47630251,47630251,0.523560209424084,8,1520,1528
SRR25023302_1_val_1_bismark_bt2_pe.bismark.cov,cases,chr2,47630265,47630265,0.458715596330275,7,1519,1526
SRR25023302_1_val_1_bismark_bt2_pe.bismark.cov,cases,chr2,47630292,47630292,0.327653997378768,5,1521,1526
SRR25023302_1_val_1_bismark_bt2_pe.bismark.cov,cases,chr2,47630294,47630294,0.525279054497702,8,1515,1523
SRR25023302_1_val_1_bismark_bt2_pe.bismark.cov,cases,chr2,128051674,128051674,0.0,0,208,208
SRR25023302_1_val_1_bismark_bt2_pe.bismark.cov,cases,chr2,128051690,128051690,1.20160213618158,9,740,749
SRR25023302_1_val_1_bismark_bt2_pe.bismark.cov,cases,chr2,128051704,128051704,0.133511348464619,1,748,749
SRR25023302_1_val_1_bismark_bt2_pe.bismark.cov,cases,chr2,128051707,128051707,0.801068090787717,6,743,749
SRR25023302_1_val_1_bismark_bt2_pe.bismark.cov,cases,chr2,128051709,128051709,0.934579439252336,7,742,749
SRR25023302_1_val_1_bismark_bt2_pe.bismark.cov,cases,chr2,128051716,128051716,0.267379679144385,2,746,748
SRR25023302_1_val_1_bismark_bt2_pe.bismark.cov,cases,chr2,128051733,128051733,0.666666666666667,5,745,750
SRR25023302_1_val_1_bismark_bt2_pe.bismark.cov,cases,chr2,128051743,128051743,0.802139037433155,6,742,748
SRR25023302_1_val_1_bismark_bt2_pe.bismark.cov,cases,chr2,178787742,178787742,91.5909090909091,403,37,440
SRR25023302_1_val_1_bismark_bt2_pe.bismark.cov,cases,chr10,89619506,89619506,97.9759645793801,1549,32,1581
SRR25023302_1_val_1_bismark_bt2_pe.bismark.cov,cases,chr10,89619510,89619510,98.2300884955752,1554,28,1582
SRR25023302_1_val_1_bismark_bt2_pe.bismark.cov,cases,chr10,89619512,89619512,98.3596214511041,1559,26,1585
SRR25023302_1_val_1_bismark_bt2_pe.bismark.cov,cases,chr10,89619522,89619522,97.3568281938326,1547,42,1589
SRR25023302_1_val_1_bismark_bt2_pe.bismark.cov,cases,chr10,89619550,89619550,96.6624685138539,1535,53,1588
SRR25023302_1_val_1_bismark_bt2_pe.bismark.cov,cases,chr10,89619555,89619555,97.7945809703844,1552,35,1587
SRR25023302_1_val_1_bismark_bt2_pe.bismark.cov,cases,chr10,89619566,89619566,92.739898989899,1469,115,1584
SRR25023302_1_val_1_bismark_bt2_pe.bismark.cov,cases,chr10,89619580,89619580,91.6666666666667,1452,132,1584
SRR25023302_1_val_1_bismark_bt2_pe.bismark.cov,cases,chr11,108093323,108093323,0.353356890459364,2,564,566
SRR25023302_1_val_1_bismark_bt2_pe.bismark.cov,cases,chr11,108093335,108093335,0.530973451327434,3,562,565
SRR25023302_1_val_1_bismark_bt2_pe.bismark.cov,cases,chr11,108093338,108093338,0.355239786856128,2,561,563
SRR25023302_1_val_1_bismark_bt2_pe.bismark.cov,cases,chr11,108093359,108093359,0.17921146953405,1,557,558
SRR25023302_1_val_1_bismark_bt2_pe.bismark.cov,cases,chr11,108093371,108093371,1.19904076738609,5,412,417
SRR25023302_1_val_1_bismark_bt2_pe.bismark.cov,cases,chr11,108093373,108093373,0.719424460431655,3,414,417
SRR25023302_1_val_1_bismark_bt2_pe.bismark.cov,cases,chr11,108093386,108093386,0.240384615384615,1,415,416
SRR25023302_1_val_1_bismark_bt2_pe.bismark.cov,cases,chr11,108093395,108093395,0.970873786407767,4,408,412
SRR25023302_1_val_1_bismark_bt2_pe.bismark.cov,cases,chr11,108093402,108093402,0.72992700729927,3,408,411
SRR25023302_1_val_1_bismark_bt2_pe.bismark.cov,cases,chr11,108093413,108093413,0.0,0,407,407
SRR25023302_1_val_1_bismark_bt2_pe.bismark.cov,cases,chr11,108093419,108093419,0.246305418719212,1,405,406
SRR25023302_1_val_1_bismark_bt2_pe.bismark.cov,cases,chr11,108093436,108093436,0.492610837438424,2,404,406
SRR25023302_1_val_1_bismark_bt2_pe.bismark.cov,cases,chr11,108093439,108093439,0.246913580246914,1,404,405
SRR25023302_1_val_1_bismark_bt2_pe.bismark.cov,cases,chr11,108093451,108093451,0.248138957816377,1,402,403
SRR25023302_1_val_1_bismark_bt2_pe.bismark.cov,cases,chr11,108093457,108093457,0.248756218905473,1,401,402
SRR25023302_1_val_1_bismark_bt2_pe.bismark.cov,cases,chr11,108093461,108093461,0.748129675810474,3,398,401
SRR25023302_1_val_1_bismark_bt2_pe.bismark.cov,cases,chr11,108093467,108093467,0.0,0,401,401
SRR25023302_1_val_1_bismark_bt2_pe.bismark.cov,cases,chr11,108093476,108093476,0.249376558603491,1,400,401
SRR25023302_1_val_1_bismark_bt2_pe.bismark.cov,cases,chr11,108093485,108093485,0.761421319796954,3,391,394
SRR25023302_1_val_1_bismark_bt2_pe.bismark.cov,cases,chr11,108093505,108093505,1.11731843575419,4,354,358
SRR25023302_1_val_1_bismark_bt2_pe.bismark.cov,cases,chr11,108093520,108093520,0.333333333333333,1,299,300
SRR25023302_1_val_1_bismark_bt2_pe.bismark.cov,cases,chr11,108093560,108093560,0.0,0,322,322
SRR25023302_1_val_1_bismark_bt2_pe.bismark.cov,cases,chr11,108093567,108093567,0.87463556851312,3,340,343
SRR25023302_1_val_1_bismark_bt2_pe.bismark.cov,cases,chr11,108093572,108093572,0.869565217391304,3,342,345
SRR25023302_1_val_1_bismark_bt2_pe.bismark.cov,cases,chr11,108093579,108093579,0.563380281690141,2,353,355
SRR25023302_1_val_1_bismark_bt2_pe.bismark.cov,cases,chr11,108093584,108093584,1.07816711590297,4,367,371
SRR25023302_1_val_1_bismark_bt2_pe.bismark.cov,cases,chr11,108093590,108093590,0.51150895140665,2,389,391
SRR25023302_1_val_1_bismark_bt2_pe.bismark.cov,cases,chr11,108093598,108093598,0.995024875621891,4,398,402
SRR25023302_1_val_1_bismark_bt2_pe.bismark.cov,cases,chr6,43543548,43543548,1.62162162162162,3,182,185
SRR25023302_1_val_1_bismark_bt2_pe.bismark.cov,cases,chr6,43543554,43543554,0.0,0,185,185
SRR25023302_1_val_1_bismark_bt2_pe.bismark.cov,cases,chr6,43543571,43543571,0.537634408602151,1,185,186
SRR25023302_1_val_1_bismark_bt2_pe.bismark.cov,cases,chr6,43543578,43543578,0.0,0,186,186
SRR25023302_1_val_1_bismark_bt2_pe.bismark.cov,cases,chr6,43543580,43543580,0.0,0,186,186
SRR25023302_1_val_1_bismark_bt2_pe.bismark.cov,cases,chr6,43543596,43543596,0.0,0,188,188
SRR25023302_1_val_1_bismark_bt2_pe.bismark.cov,cases,chr6,43543608,43543608,0.0,0,186,186
SRR25023302_1_val_1_bismark_bt2_pe.bismark.cov,cases,chr6,43543613,43543613,1.06951871657754,2,185,187
SRR25023302_1_val_1_bismark_bt2_pe.bismark.cov,cases,chr6,43543615,43543615,2.13903743315508,4,183,187
SRR25023302_1_val_1_bismark_bt2_pe.bismark.cov,cases,chr6,43543618,43543618,1.60427807486631,3,184,187
SRR25023302_1_val_1_bismark_bt2_pe.bismark.cov,cases,chr6,43543624,43543624,1.0752688172043,2,184,186
SRR25023302_1_val_1_bismark_bt2_pe.bismark.cov,cases,chr6,43543642,43543642,0.0,0,186,186
SRR25023302_1_val_1_bismark_bt2_pe.bismark.cov,cases,chr6,43543650,43543650,0.0,0,187,187
SRR25023302_1_val_1_bismark_bt2_pe.bismark.cov,cases,chr6,43543657,43543657,0.540540540540541,1,184,185
SRR25023302_1_val_1_bismark_bt2_pe.bismark.cov,cases,chr6,43543669,43543669,0.540540540540541,1,184,185
SRR25023302_1_val_1_bismark_bt2_pe.bismark.cov,cases,chr6,43543672,43543672,0.546448087431694,1,182,183
SRR25023302_1_val_1_bismark_bt2_pe.bismark.cov,cases,chr6,43543682,43543682,0.0,0,182,182
SRR25023302_1_val_1_bismark_bt2_pe.bismark.cov,cases,chr6,43543691,43543691,0.552486187845304,1,180,181
SRR25023302_1_val_1_bismark_bt2_pe.bismark.cov,cases,chr6,43543696,43543696,6.17977528089888,11,167,178
SRR25023302_1_val_1_bismark_bt2_pe.bismark.cov,cases,chr6,43543698,43543698,0.561797752808989,1,177,178
SRR25023302_1_val_1_bismark_bt2_pe.bismark.cov,cases,chr6,43543701,43543701,2.24719101123596,4,174,178
SRR25023302_1_val_1_bismark_bt2_pe.bismark.cov,cases,chr6,43543705,43543705,0.0,0,178,178
SRR25023302_1_val_1_bismark_bt2_pe.bismark.cov,cases,chr6,43543708,43543708,0.0,0,178,178
SRR25023302_1_val_1_bismark_bt2_pe.bismark.cov,cases,chr6,43543733,43543733,0.552486187845304,1,180,181
SRR25023302_1_val_1_bismark_bt2_pe.bismark.cov,cases,chr6,43543747,43543747,1.0989010989011,2,180,182
SRR25023302_1_val_1_bismark_bt2_pe.bismark.cov,cases,chr6,43543749,43543749,0.0,0,182,182
SRR25023302_1_val_1_bismark_bt2_pe.bismark.cov,cases,chr6,43543763,43543763,0.555555555555556,1,179,180
SRR25023302_1_val_1_bismark_bt2_pe.bismark.cov,cases,chr6,43543766,43543766,0.552486187845304,1,180,181
SRR25023302_1_val_1_bismark_bt2_pe.bismark.cov,cases,chr6,43543771,43543771,1.0989010989011,2,180,182
SRR25023302_1_val_1_bismark_bt2_pe.bismark.cov,cases,chr6,43543775,43543775,0.0,0,179,179
SRR25023302_1_val_1_bismark_bt2_pe.bismark.cov,cases,chr6,43543777,43543777,0.555555555555556,1,179,180
SRR25023302_1_val_1_bismark_bt2_pe.bismark.cov,cases,chr6,43543781,43543781,0.0,0,182,182
SRR25023302_1_val_1_bismark_bt2_pe.bismark.cov,cases,chr6,43543786,43543786,0.549450549450549,1,181,182
SRR25023302_1_val_1_bismark_bt2_pe.bismark.cov,cases,chr6,43543794,43543794,1.11111111111111,2,178,180
SRR25023302_1_val_1_bismark_bt2_pe.bismark.cov,cases,chr6,43543798,43543798,1.11111111111111,2,178,180
SRR25023302_1_val_1_bismark_bt2_pe.bismark.cov,cases,chr6,43543800,43543800,0.558659217877095,1,178,179
SRR25023302_1_val_1_bismark_bt2_pe.bismark.cov,cases,chr6,43543804,43543804,0.555555555555556,1,179,180
SRR25023302_1_val_1_bismark_bt2_pe.bismark.cov,cases,chr6,43543806,43543806,1.66666666666667,3,177,180
SRR25023302_1_val_1_bismark_bt2_pe.bismark.cov,cases,chr6,43543815,43543815,0.0,0,181,181
SRR25023302_1_val_1_bismark_bt2_pe.bismark.cov,cases,chr6,43543822,43543822,0.555555555555556,1,179,180
SRR25023302_1_val_1_bismark_bt2_pe.bismark.cov,cases,chr17,41277106,41277106,1.0507880910683,18,1695,1713
SRR25023302_1_val_1_bismark_bt2_pe.bismark.cov,cases,chr17,41277115,41277115,0.75713453698311,13,1704,1717
SRR25023302_1_val_1_bismark_bt2_pe.bismark.cov,cases,chr17,41277117,41277117,0.69889341875364,12,1705,1717
SRR25023302_1_val_1_bismark_bt2_pe.bismark.cov,cases,chr17,41277153,41277153,0.817757009345794,14,1698,1712
SRR25023302_1_val_1_bismark_bt2_pe.bismark.cov,cases,chr17,41277160,41277160,0.991831971995333,17,1697,1714
SRR25023302_1_val_1_bismark_bt2_pe.bismark.cov,cases,chr17,41277174,41277174,1.28279883381924,22,1693,1715
SRR25023302_1_val_1_bismark_bt2_pe.bismark.cov,cases,chr17,41277187,41277187,5.51267916207277,50,857,907
SRR25023302_1_val_1_bismark_bt2_pe.bismark.cov,cases,chr17,41277214,41277214,0.812064965197216,14,1710,1724
SRR25023302_1_val_1_bismark_bt2_pe.bismark.cov,cases,chr17,41277232,41277232,0.809248554913295,14,1716,1730
SRR25023302_1_val_1_bismark_bt2_pe.bismark.cov,cases,chr17,56769746,56769746,89.9328859060403,134,15,149
SRR25023302_1_val_1_bismark_bt2_pe.bismark.cov,cases,chr17,56769760,56769760,85.9060402684564,128,21,149
SRR25023302_1_val_1_bismark_bt2_pe.bismark.cov,cases,chr17,56769767,56769767,75.5102040816327,111,36,147
SRR25023302_1_val_1_bismark_bt2_pe.bismark.cov,cases,chr17,56769830,56769830,1.97368421052632,3,149,152
SRR25023302_1_val_1_bismark_bt2_pe.bismark.cov,cases,chr17,56769866,56769866,1.32450331125828,2,149,151
SRR25023302_1_val_1_bismark_bt2_pe.bismark.cov,cases,chr17,56769883,56769883,0.0,0,151,151
SRR25023302_1_val_1_bismark_bt2_pe.bismark.cov,cases,chr17,56769891,56769891,0.0,0,151,151
SRR25023302_1_val_1_bismark_bt2_pe.bismark.cov,cases,chr17,56769895,56769895,0.662251655629139,1,150,151
SRR25023302_1_val_1_bismark_bt2_pe.bismark.cov,cases,chr17,56769904,56769904,0.671140939597315,1,148,149
SRR25023302_1_val_1_bismark_bt2_pe.bismark.cov,cases,chr17,56769912,56769912,2.01342281879195,3,146,149
SRR25023302_1_val_1_bismark_bt2_pe.bismark.cov,cases,chr17,56769922,56769922,0.0,0,148,148
SRR25023302_1_val_1_bismark_bt2_pe.bismark.cov,cases,chr17,56769929,56769929,0.0,0,146,146
SRR25023302_1_val_1_bismark_bt2_pe.bismark.cov,cases,chr17,56769936,56769936,0.0,0,146,146
SRR25023302_1_val_1_bismark_bt2_pe.bismark.cov,cases,chr17,56769941,56769941,0.0,0,146,146
SRR25023302_1_val_1_bismark_bt2_pe.bismark.cov,cases,chr17,56769944,56769944,0.0,0,147,147
SRR25023302_1_val_1_bismark_bt2_pe.bismark.cov,cases,chr17,56769948,56769948,0.680272108843537,1,146,147
SRR25023302_1_val_1_bismark_bt2_pe.bismark.cov,cases,chr17,56769956,56769956,0.0,0,138,138
SRR25023302_1_val_1_bismark_bt2_pe.bismark.cov,cases,chr17,56769962,56769962,0.0,0,130,130
SRR25023302_1_val_1_bismark_bt2_pe.bismark.cov,cases,chr17,56769966,56769966,0.0,0,128,128
SRR25023302_1_val_1_bismark_bt2_pe.bismark.cov,cases,chr17,56769982,56769982,0.0,0,135,135
SRR25023302_1_val_1_bismark_bt2_pe.bismark.cov,cases,chr17,56770003,56770003,0.0,0,139,139
SRR25023302_1_val_1_bismark_bt2_pe.bismark.cov,cases,chr17,56770008,56770008,0.0,0,139,139
SRR25023302_1_val_1_bismark_bt2_pe.bismark.cov,cases,chr17,56770010,56770010,0.0,0,139,139
SRR25023302_1_val_1_bismark_bt2_pe.bismark.cov,cases,chr17,56770018,56770018,0.0,0,144,144
SRR25023302_1_val_1_bismark_bt2_pe.bismark.cov,cases,chr17,56770023,56770023,0.0,0,144,144
SRR25023302_1_val_1_bismark_bt2_pe.bismark.cov,cases,chr17,56770038,56770038,0.0,0,146,146
SRR25023302_1_val_1_bismark_bt2_pe.bismark.cov,cases,chr17,56770057,56770057,0.0,0,147,147
SRR25023302_1_val_1_bismark_bt2_pe.bismark.cov,cases,chr17,56770069,56770069,0.0,0,147,147
SRR25023302_1_val_1_bismark_bt2_pe.bismark.cov,cases,chr17,56770074,56770074,0.0,0,147,147
SRR25023302_1_val_1_bismark_bt2_pe.bismark.cov,cases,chr17,56770093,56770093,0.0,0,148,148
SRR25023302_1_val_1_bismark_bt2_pe.bismark.cov,cases,chr17,59940970,59940970,1.06157112526539,5,466,471
SRR25023302_1_val_1_bismark_bt2_pe.bismark.cov,cases,chr17,59940975,59940975,1.06157112526539,5,466,471
SRR25023302_1_val_1_bismark_bt2_pe.bismark.cov,cases,chr17,59940988,59940988,0.425531914893617,2,468,470
SRR25023302_1_val_1_bismark_bt2_pe.bismark.cov,cases,chr17,59940997,59940997,0.869565217391304,4,456,460
SRR25023302_1_val_1_bismark_bt2_pe.bismark.cov,cases,chr17,59941017,59941017,0.0,0,274,274
SRR25023302_1_val_1_bismark_bt2_pe.bismark.cov,cases,chr17,59941051,59941051,0.0,0,465,465
SRR25023302_1_val_1_bismark_bt2_pe.bismark.cov,cases,chr17,59941053,59941053,1.74418604651163,9,507,516
SRR25023302_1_val_1_bismark_bt2_pe.bismark.cov,cases,chr17,59941056,59941056,0.0,0,463,463
SRR25023302_1_val_1_bismark_bt2_pe.bismark.cov,cases,chr17,59941067,59941067,0.213219616204691,1,468,469
SRR25023302_1_val_1_bismark_bt2_pe.bismark.cov,cases,chr17,59941110,59941110,0.568181818181818,3,525,528
SRR25023302_1_val_1_bismark_bt2_pe.bismark.cov,cases,chr17,59941133,59941133,0.943396226415094,5,525,530
SRR25023302_1_val_1_bismark_bt2_pe.bismark.cov,cases,chr17,59941136,59941136,0.189035916824197,1,528,529
SRR25023302_1_val_1_bismark_bt2_pe.bismark.cov,cases,chr17,59941187,59941187,0.378787878787879,2,526,528
SRR25023302_1_val_1_bismark_bt2_pe.bismark.cov,cases,chr17,59941191,59941191,0.378071833648393,2,527,529
SRR25023302_1_val_1_bismark_bt2_pe.bismark.cov,cases,chr17,59941201,59941201,0.97323600973236,4,407,411
SRR25023302_1_val_1_bismark_bt2_pe.bismark.cov,cases,chr17,59941202,59941202,0.0,0,105,105
SRR25023302_1_val_1_bismark_bt2_pe.bismark.cov,cases,chr17,76325846,76325846,54.7169811320755,29,24,53
SRR25023302_1_val_1_bismark_bt2_pe.bismark.cov,cases,chr17,76325851,76325851,41.5094339622642,22,31,53
SRR25023302_1_val_1_bismark_bt2_pe.bismark.cov,cases,chr17,76325865,76325865,33.9622641509434,18,35,53
SRR25023302_1_val_1_bismark_bt2_pe.bismark.cov,cases,chr17,76325979,76325979,67.9245283018868,36,17,53
SRR25023302_1_val_1_bismark_bt2_pe.bismark.cov,cases,chr8,30890012,30890012,59.7058823529412,203,137,340
SRR25023302_1_val_1_bismark_bt2_pe.bismark.cov,cases,chr8,30890034,30890034,68.75,231,105,336
SRR25023302_1_val_1_bismark_bt2_pe.bismark.cov,cases,chr8,30890051,30890051,97.6047904191617,326,8,334
SRR25023302_1_val_1_bismark_bt2_pe.bismark.cov,cases,chr8,30890057,30890057,82.0359281437126,274,60,334
SRR25023302_1_val_1_bismark_bt2_pe.bismark.cov,cases,chr8,30890073,30890073,53.7537537537538,179,154,333
SRR25023302_1_val_1_bismark_bt2_pe.bismark.cov,cases,chr8,30890108,30890108,17.2727272727273,57,273,330
SRR25023302_1_val_1_bismark_bt2_pe.bismark.cov,cases,chr8,30890133,30890133,26.5060240963855,88,244,332
SRR25023302_1_val_1_bismark_bt2_pe.bismark.cov,cases,chr8,30890139,30890139,48.6404833836858,161,170,331
SRR25023302_1_val_1_bismark_bt2_pe.bismark.cov,cases,chr8,30890145,30890145,14.3712574850299,48,286,334
SRR25023302_1_val_1_bismark_bt2_pe.bismark.cov,cases,chr8,30890170,30890170,18.2634730538922,61,273,334
SRR25023302_1_val_1_bismark_bt2_pe.bismark.cov,cases,chr8,30890172,30890172,15.7099697885196,52,279,331
SRR25023302_1_val_1_bismark_bt2_pe.bismark.cov,cases,chr8,90997245,90997245,14.1304347826087,13,79,92
SRR25023302_1_val_1_bismark_bt2_pe.bismark.cov,cases,chr8,90997299,90997299,0.0,0,91,91
SRR25023302_1_val_1_bismark_bt2_pe.bismark.cov,cases,chr8,90997454,90997454,20.0,16,64,80
SRR25023302_1_val_1_bismark_bt2_pe.bismark.cov,cases,chr8,90997482,90997482,96.3855421686747,80,3,83
SRR25023302_1_val_1_bismark_bt2_pe.bismark.cov,cases,chr15,89786999,89786999,1.70940170940171,4,230,234
SRR25023302_1_val_1_bismark_bt2_pe.bismark.cov,cases,chr15,89787007,89787007,0.4149377593361,1,240,241
SRR25023302_1_val_1_bismark_bt2_pe.bismark.cov,cases,chr15,89787009,89787009,1.2448132780083,3,238,241
SRR25023302_1_val_1_bismark_bt2_pe.bismark.cov,cases,chr15,89787018,89787018,0.413223140495868,1,241,242
SRR25023302_1_val_1_bismark_bt2_pe.bismark.cov,cases,chr15,89787032,89787032,1.2448132780083,3,238,241
SRR25023302_1_val_1_bismark_bt2_pe.bismark.cov,cases,chr15,89787034,89787034,0.4149377593361,1,240,241
SRR25023302_1_val_1_bismark_bt2_pe.bismark.cov,cases,chr15,89787036,89787036,0.833333333333333,2,238,240
SRR25023302_1_val_1_bismark_bt2_pe.bismark.cov,cases,chr15,89787045,89787045,0.0,0,242,242
SRR25023302_1_val_1_bismark_bt2_pe.bismark.cov,cases,chr15,89787048,89787048,0.826446280991736,2,240,242
SRR25023302_1_val_1_bismark_bt2_pe.bismark.cov,cases,chr15,89787058,89787058,1.2396694214876,3,239,242
SRR25023302_1_val_1_bismark_bt2_pe.bismark.cov,cases,chr15,89787060,89787060,1.2396694214876,3,239,242
SRR25023302_1_val_1_bismark_bt2_pe.bismark.cov,cases,chr15,89787066,89787066,0.4149377593361,1,240,241
SRR25023302_1_val_1_bismark_bt2_pe.bismark.cov,cases,chr15,89787077,89787077,0.413223140495868,1,241,242
SRR25023302_1_val_1_bismark_bt2_pe.bismark.cov,cases,chr15,89787087,89787087,0.416666666666667,1,239,240
SRR25023302_1_val_1_bismark_bt2_pe.bismark.cov,cases,chr15,89787103,89787103,0.0,0,238,238
SRR25023302_1_val_1_bismark_bt2_pe.bismark.cov,cases,chr15,89787109,89787109,0.843881856540084,2,235,237
SRR25023302_1_val_1_bismark_bt2_pe.bismark.cov,cases,chr15,89787113,89787113,0.0,0,237,237
SRR25023302_1_val_1_bismark_bt2_pe.bismark.cov,cases,chr15,89787120,89787120,0.0,0,238,238
SRR25023302_1_val_1_bismark_bt2_pe.bismark.cov,cases,chr15,89787150,89787150,1.28755364806867,3,230,233
SRR25023302_1_val_1_bismark_bt2_pe.bismark.cov,cases,chr15,89787154,89787154,0.862068965517241,2,230,232
SRR25023302_1_val_1_bismark_bt2_pe.bismark.cov,cases,chr15,89787164,89787164,0.0,0,232,232
SRR25023302_1_val_1_bismark_bt2_pe.bismark.cov,cases,chr15,89787168,89787168,0.0,0,232,232
SRR25023302_1_val_1_bismark_bt2_pe.bismark.cov,cases,chr15,89787171,89787171,0.434782608695652,1,229,230
SRR25023302_1_val_1_bismark_bt2_pe.bismark.cov,cases,chr15,89787182,89787182,0.873362445414847,2,227,229
SRR25023302_1_val_1_bismark_bt2_pe.bismark.cov,cases,chr15,89787184,89787184,0.0,0,227,227
SRR25023302_1_val_1_bismark_bt2_pe.bismark.cov,cases,chr15,89787190,89787190,0.0,0,223,223
SRR25023302_1_val_1_bismark_bt2_pe.bismark.cov,cases,chr15,89787205,89787205,0.0,0,201,201
SRR25023302_1_val_1_bismark_bt2_pe.bismark.cov,cases,chr15,89787212,89787212,1.23456790123457,2,160,162
SRR25023302_1_val_1_bismark_bt2_pe.bismark.cov,cases,chr15,89787223,89787223,0.0,0,126,126
SRR25023302_1_val_1_bismark_bt2_pe.bismark.cov,cases,chr15,89787226,89787226,0.757575757575758,1,131,132
SRR25023302_1_val_1_bismark_bt2_pe.bismark.cov,cases,chr15,89787238,89787238,0.0,0,144,144
SRR25023302_1_val_1_bismark_bt2_pe.bismark.cov,cases,chr15,89787260,89787260,0.578034682080925,1,172,173
SRR25023302_1_val_1_bismark_bt2_pe.bismark.cov,cases,chr15,89787272,89787272,0.568181818181818,1,175,176
SRR25023302_1_val_1_bismark_bt2_pe.bismark.cov,cases,chr15,89787288,89787288,0.0,0,205,205
SRR25023302_1_val_1_bismark_bt2_pe.bismark.cov,cases,chr15,89787293,89787293,0.0,0,211,211
SRR25023302_1_val_1_bismark_bt2_pe.bismark.cov,cases,chr15,89787295,89787295,0.956937799043062,2,207,209
SRR25023302_1_val_1_bismark_bt2_pe.bismark.cov,cases,chr15,89787304,89787304,0.0,0,222,222
SRR25023302_1_val_1_bismark_bt2_pe.bismark.cov,cases,chr15,89787335,89787335,0.0,0,236,236
SRR25023302_1_val_1_bismark_bt2_pe.bismark.cov,cases,chr14,45604787,45604787,0.740740740740741,4,536,540
SRR25023302_1_val_1_bismark_bt2_pe.bismark.cov,cases,chr14,45604794,45604794,0.185185185185185,1,539,540
SRR25023302_1_val_1_bismark_bt2_pe.bismark.cov,cases,chr16,23652769,23652769,0.133511348464619,1,748,749
SRR25023302_1_val_1_bismark_bt2_pe.bismark.cov,cases,chr16,23652783,23652783,1.59362549800797,12,741,753
SRR25023302_1_val_1_bismark_bt2_pe.bismark.cov,cases,chr16,23652787,23652787,0.666666666666667,5,745,750
SRR25023302_1_val_1_bismark_bt2_pe.bismark.cov,cases,chr16,23652797,23652797,0.402684563758389,3,742,745
SRR25023302_1_val_1_bismark_bt2_pe.bismark.cov,cases,chr16,23652818,23652818,0.404858299595142,3,738,741
SRR25023302_1_val_1_bismark_bt2_pe.bismark.cov,cases,chr16,23652838,23652838,0.269541778975741,2,740,742
SRR25023302_1_val_1_bismark_bt2_pe.bismark.cov,cases,chr16,23652857,23652857,0.661375661375661,5,751,756
SRR25023302_1_val_1_bismark_bt2_pe.bismark.cov,cases,chr16,23652860,23652860,0.264550264550265,2,754,756
SRR25023302_1_val_1_bismark_bt2_pe.bismark.cov,cases,chr16,23652876,23652876,0.660501981505945,5,752,757
SRR25023302_1_val_1_bismark_bt2_pe.bismark.cov,cases,chr16,23652906,23652906,0.927152317880795,7,748,755
SRR25023302_1_val_1_bismark_bt2_pe.bismark.cov,cases,chr16,23652911,23652911,0.794701986754967,6,749,755
SRR25023302_1_val_1_bismark_bt2_pe.bismark.cov,cases,chr16,23652916,23652916,0.94722598105548,7,732,739
SRR25023302_1_val_1_bismark_bt2_pe.bismark.cov,cases,chr16,23652918,23652918,1.19363395225464,9,745,754
SRR25023302_1_val_1_bismark_bt2_pe.bismark.cov,cases,chr7,6048860,6048860,0.0,0,23,23
SRR25023302_1_val_1_bismark_bt2_pe.bismark.cov,cases,chr7,6048869,6048869,0.41371158392435,21,5055,5076
SRR25023302_1_val_1_bismark_bt2_pe.bismark.cov,cases,chr7,6048876,6048876,0.27564481197086,14,5065,5079
SRR25023302_1_val_1_bismark_bt2_pe.bismark.cov,cases,chr7,6048884,6048884,0.513630975898854,26,5036,5062
SRR25023302_1_val_1_bismark_bt2_pe.bismark.cov,cases,chr7,6048888,6048888,0.335769306735137,17,5046,5063
SRR25023302_1_val_1_bismark_bt2_pe.bismark.cov,cases,chr7,6048892,6048892,0.41403785488959,21,5051,5072
SRR25023302_1_val_1_bismark_bt2_pe.bismark.cov,cases,chr7,6048904,6048904,0.0,0,1034,1034
SRR25023302_1_val_1_bismark_bt2_pe.bismark.cov,cases,chr7,6048918,6048918,0.608798114689709,31,5061,5092
SRR25023302_1_val_1_bismark_bt2_pe.bismark.cov,cases,chr7,6048925,6048925,0.353218210361068,18,5078,5096
SRR25023302_1_val_1_bismark_bt2_pe.bismark.cov,cases,chr7,6048928,6048928,0.686543742644174,35,5063,5098
SRR25023302_1_val_1_bismark_bt2_pe.bismark.cov,cases,chr7,6048940,6048940,0.392387679026879,20,5077,5097
SRR25023302_1_val_1_bismark_bt2_pe.bismark.cov,cases,chr7,6048951,6048951,0.274725274725275,14,5082,5096
SRR25023302_1_val_1_bismark_bt2_pe.bismark.cov,cases,chr7,6048966,6048966,0.451157316594743,23,5075,5098
SRR25023302_1_val_1_bismark_bt2_pe.bismark.cov,cases,chr7,6048968,6048968,0.492416781563916,25,5052,5077
SRR25023302_1_val_1_bismark_bt2_pe.bismark.cov,cases,chrX,14891454,14891454,20.8653846153846,651,2469,3120
SRR25023302_1_val_1_bismark_bt2_pe.bismark.cov,cases,chrX,14891470,14891470,16.448,514,2611,3125
SRR25023302_1_val_1_bismark_bt2_pe.bismark.cov,cases,chrX,14891474,14891474,26.5345268542199,830,2298,3128
SRR25023302_1_val_1_bismark_bt2_pe.bismark.cov,cases,chrX,14891488,14891488,38.5723431498079,1205,1919,3124
SRR25023302_1_val_1_bismark_bt2_pe.bismark.cov,cases,chrX,14891493,14891493,44.5332480818414,1393,1735,3128
SRR25023302_1_val_1_bismark_bt2_pe.bismark.cov,cases,chrX,14891496,14891496,25.5925688661115,799,2323,3122
SRR25023302_1_val_1_bismark_bt2_pe.bismark.cov,cases,chrX,14891499,14891499,17.696,553,2572,3125
SRR25023302_1_val_1_bismark_bt2_pe.bismark.cov,cases,chrX,14891509,14891509,44.49423815621,1390,1734,3124
SRR25023302_1_val_1_bismark_bt2_pe.bismark.cov,cases,chrX,14891516,14891516,37.0642788615286,1159,1968,3127
SRR25023302_1_val_1_bismark_bt2_pe.bismark.cov,cases,chrX,14891524,14891524,35.3241775790482,1106,2025,3131
SRR25023302_1_val_1_bismark_bt2_pe.bismark.cov,cases,chrX,14891526,14891526,31.3856960408685,983,2149,3132
SRR25023302_1_val_1_bismark_bt2_pe.bismark.cov,cases,chrX,14891530,14891530,37.9244074311339,1184,1938,3122
SRR25023302_1_val_1_bismark_bt2_pe.bismark.cov,cases,chr22,29137950,29137950,0.0,0,61,61
SRR25023302_1_val_1_bismark_bt2_pe.bismark.cov,cases,chr22,29137964,29137964,0.0,0,53,53
SRR25023302_1_val_1_bismark_bt2_pe.bismark.cov,cases,chr22,29137975,29137975,0.0,0,52,52
SRR25023302_1_val_1_bismark_bt2_pe.bismark.cov,cases,chr22,29137985,29137985,0.0,0,39,39
SRR25023302_1_val_1_bismark_bt2_pe.bismark.cov,cases,chr22,29137993,29137993,0.0,0,33,33
SRR25023302_1_val_1_bismark_bt2_pe.bismark.cov,cases,chr22,29138031,29138031,1.75438596491228,1,56,57
SRR25023302_1_val_1_bismark_bt2_pe.bismark.cov,cases,chr22,29138052,29138052,0.0,0,60,60
SRR25023302_1_val_1_bismark_bt2_pe.bismark.cov,cases,chr22,29138062,29138062,0.0,0,60,60
SRR25023302_1_val_1_bismark_bt2_pe.bismark.cov,cases,chr22,29138075,29138075,1.66666666666667,1,59,60
SRR25023302_1_val_1_bismark_bt2_pe.bismark.cov,cases,chr22,29138078,29138078,1.69491525423729,1,58,59
SRR25023302_1_val_1_bismark_bt2_pe.bismark.cov,cases,chr22,29138091,29138091,0.0,0,53,53
SRR25023302_1_val_1_bismark_bt2_pe.bismark.cov,cases,chr22,29138102,29138102,0.0,0,60,60
SRR25023302_1_val_1_bismark_bt2_pe.bismark.cov,cases,chr22,29138115,29138115,0.0,0,59,59
SRR25023302_1_val_1_bismark_bt2_pe.bismark.cov,cases,chr22,29138134,29138134,0.0,0,60,60
SRR25023302_1_val_1_bismark_bt2_pe.bismark.cov,cases,chr22,29138158,29138158,1.61290322580645,1,61,62
SRR25023302_1_val_1_bismark_bt2_pe.bismark.cov,cases,chr22,29138168,29138168,0.0,0,61,61
SRR25023302_1_val_1_bismark_bt2_pe.bismark.cov,cases,chr22,29138176,29138176,1.63934426229508,1,60,61
SRR25023302_1_val_1_bismark_bt2_pe.bismark.cov,cases,chr22,29138179,29138179,0.0,0,62,62
SRR25023302_1_val_1_bismark_bt2_pe.bismark.cov,cases,chr22,29138185,29138185,0.0,0,63,63
SRR25023302_1_val_1_bismark_bt2_pe.bismark.cov,cases,chr22,29138202,29138202,1.63934426229508,1,60,61
SRR25023302_1_val_1_bismark_bt2_pe.bismark.cov,cases,chr22,29138216,29138216,1.61290322580645,1,61,62
SRR25023302_1_val_1_bismark_bt2_pe.bismark.cov,cases,chr22,29138219,29138219,0.0,0,62,62
SRR25023302_1_val_1_bismark_bt2_pe.bismark.cov,cases,chr22,29138234,29138234,0.0,0,62,62
SRR25023302_1_val_1_bismark_bt2_pe.bismark.cov,cases,chr22,29138238,29138238,0.0,0,61,61
SRR25023303_1_val_1_bismark_bt2_pe.bismark.cov,cases,chr3,37034307,37034307,99.8483469821049,3292,5,3297
SRR25023303_1_val_1_bismark_bt2_pe.bismark.cov,cases,chr3,37034316,37034316,0.637135922330097,21,3275,3296
SRR25023303_1_val_1_bismark_bt2_pe.bismark.cov,cases,chr3,37034324,37034324,0.272975432211101,9,3288,3297
SRR25023303_1_val_1_bismark_bt2_pe.bismark.cov,cases,chr3,37034330,37034330,0.878787878787879,29,3271,3300
SRR25023303_1_val_1_bismark_bt2_pe.bismark.cov,cases,chr3,37034344,37034344,0.637135922330097,21,3275,3296
SRR25023303_1_val_1_bismark_bt2_pe.bismark.cov,cases,chr3,37034346,37034346,0.515151515151515,17,3283,3300
SRR25023303_1_val_1_bismark_bt2_pe.bismark.cov,cases,chr3,37034348,37034348,0.333636639369123,11,3286,3297
SRR25023303_1_val_1_bismark_bt2_pe.bismark.cov,cases,chr3,37034352,37034352,0.605877006967586,20,3281,3301
SRR25023303_1_val_1_bismark_bt2_pe.bismark.cov,cases,chr3,37034355,37034355,0.423985463355542,14,3288,3302
SRR25023303_1_val_1_bismark_bt2_pe.bismark.cov,cases,chr3,37034359,37034359,0.272644653135414,9,3292,3301
SRR25023303_1_val_1_bismark_bt2_pe.bismark.cov,cases,chr3,37034369,37034369,0.652579241765072,21,3197,3218
SRR25023303_1_val_1_bismark_bt2_pe.bismark.cov,cases,chr3,37034373,37034373,0.39417828987265,13,3285,3298
SRR25023303_1_val_1_bismark_bt2_pe.bismark.cov,cases,chr3,37034382,37034382,0.576106731352335,19,3279,3298
SRR25023303_1_val_1_bismark_bt2_pe.bismark.cov,cases,chr3,37034394,37034394,0.393939393939394,13,3287,3300
SRR25023303_1_val_1_bismark_bt2_pe.bismark.cov,cases,chr3,37034402,37034402,0.363856882959369,12,3286,3298
SRR25023303_1_val_1_bismark_bt2_pe.bismark.cov,cases,chr3,37034409,37034409,0.424371021521673,14,3285,3299
SRR25023303_1_val_1_bismark_bt2_pe.bismark.cov,cases,chr3,37034412,37034412,0.605877006967586,20,3281,3301
SRR25023303_1_val_1_bismark_bt2_pe.bismark.cov,cases,chr3,37034414,37034414,0.454545454545455,15,3285,3300
SRR25023303_1_val_1_bismark_bt2_pe.bismark.cov,cases,chr3,37034418,37034418,0.24264482863209,8,3289,3297
SRR25023303_1_val_1_bismark_bt2_pe.bismark.cov,cases,chr3,37034420,37034420,0.182038834951456,6,3290,3296
SRR25023303_1_val_1_bismark_bt2_pe.bismark.cov,cases,chr3,37034430,37034430,0.515463917525773,17,3281,3298
SRR25023303_1_val_1_bismark_bt2_pe.bismark.cov,cases,chr3,37034438,37034438,0.212378640776699,7,3289,3296
SRR25023303_1_val_1_bismark_bt2_pe.bismark.cov,cases,chr3,37034441,37034441,0.485436893203883,16,3280,3296
SRR25023303_1_val_1_bismark_bt2_pe.bismark.cov,cases,chr3,37034466,37034466,99.9390801096558,3281,2,3283
SRR25023303_1_val_1_bismark_bt2_pe.bismark.cov,cases,chr3,37034997,37034997,0.323947171692001,13,4000,4013
SRR25023303_1_val_1_bismark_bt2_pe.bismark.cov,cases,chr3,37035012,37035012,0.298953662182362,12,4002,4014
SRR25023303_1_val_1_bismark_bt2_pe.bismark.cov,cases,chr3,37035032,37035032,0.274040857000498,11,4003,4014
SRR25023303_1_val_1_bismark_bt2_pe.bismark.cov,cases,chr3,37035043,37035043,0.273699925354566,11,4008,4019
SRR25023303_1_val_1_bismark_bt2_pe.bismark.cov,cases,chr3,37035047,37035047,0.273768043802887,11,4007,4018
SRR25023303_1_val_1_bismark_bt2_pe.bismark.cov,cases,chr3,37035063,37035063,0.199104031856645,8,4010,4018
SRR25023303_1_val_1_bismark_bt2_pe.bismark.cov,cases,chr3,37035066,37035066,0.373412994772218,15,4002,4017
SRR25023303_1_val_1_bismark_bt2_pe.bismark.cov,cases,chr3,37035074,37035074,0.27431421446384,11,3999,4010
SRR25023303_1_val_1_bismark_bt2_pe.bismark.cov,cases,chr3,37035090,37035090,0.598503740648379,24,3986,4010
SRR25023303_1_val_1_bismark_bt2_pe.bismark.cov,cases,chr3,37035095,37035095,0.324189526184539,13,3997,4010
SRR25023303_1_val_1_bismark_bt2_pe.bismark.cov,cases,chr3,37035097,37035097,0.348779272546089,14,4000,4014
SRR25023303_1_val_1_bismark_bt2_pe.bismark.cov,cases,chr3,37035100,37035100,0.323866467364225,13,4001,4014
SRR25023303_1_val_1_bismark_bt2_pe.bismark.cov,cases,chr3,37035117,37035117,0.323947171692001,13,4000,4013
SRR25023303_1_val_1_bismark_bt2_pe.bismark.cov,cases,chr3,142297977,142297977,0.62667860340197,7,1110,1117
SRR25023303_1_val_1_bismark_bt2_pe.bismark.cov,cases,chr3,142298019,142298019,0.893655049151028,10,1109,1119
SRR25023303_1_val_1_bismark_bt2_pe.bismark.cov,cases,chr3,142298045,142298045,0.894454382826476,10,1108,1118
SRR25023303_1_val_1_bismark_bt2_pe.bismark.cov,cases,chr3,142298054,142298054,3.6003600360036,40,1071,1111
SRR25023303_1_val_1_bismark_bt2_pe.bismark.cov,cases,chr13,32889392,32889392,14.7537227949599,644,3721,4365
SRR25023303_1_val_1_bismark_bt2_pe.bismark.cov,cases,chr13,32889434,32889434,1.49322306455318,65,4288,4353
SRR25023303_1_val_1_bismark_bt2_pe.bismark.cov,cases,chr13,32889461,32889461,0.345224395857307,15,4330,4345
SRR25023303_1_val_1_bismark_bt2_pe.bismark.cov,cases,chr13,32889470,32889470,0.206801470588235,9,4343,4352
SRR25023303_1_val_1_bismark_bt2_pe.bismark.cov,cases,chr13,32889484,32889484,0.321765111468628,14,4337,4351
SRR25023303_1_val_1_bismark_bt2_pe.bismark.cov,cases,chr13,108867034,108867034,46.9059405940594,379,429,808
SRR25023303_1_val_1_bismark_bt2_pe.bismark.cov,cases,chr13,108867044,108867044,61.5667074663403,503,314,817
SRR25023303_1_val_1_bismark_bt2_pe.bismark.cov,cases,chr13,108867051,108867051,57.6312576312576,472,347,819
SRR25023303_1_val_1_bismark_bt2_pe.bismark.cov,cases,chr13,108867109,108867109,86.2362971985384,708,113,821
SRR25023303_1_val_1_bismark_bt2_pe.bismark.cov,cases,chr13,108867112,108867112,92.2141119221411,758,64,822
SRR25023303_1_val_1_bismark_bt2_pe.bismark.cov,cases,chr13,108867124,108867124,75.4257907542579,620,202,822
SRR25023303_1_val_1_bismark_bt2_pe.bismark.cov,cases,chr13,108867135,108867135,58.8522588522589,482,337,819
SRR25023303_1_val_1_bismark_bt2_pe.bismark.cov,cases,chr13,108867155,108867155,53.0413625304136,436,386,822
SRR25023303_1_val_1_bismark_bt2_pe.bismark.cov,cases,chr11,108093323,108093323,0.938967136150235,10,1055,1065
SRR25023303_1_val_1_bismark_bt2_pe.bismark.cov,cases,chr11,108093335,108093335,0.281425891181989,3,1063,1066
SRR25023303_1_val_1_bismark_bt2_pe.bismark.cov,cases,chr11,108093338,108093338,0.375586854460094,4,1061,1065
SRR25023303_1_val_1_bismark_bt2_pe.bismark.cov,cases,chr11,108093359,108093359,0.0949667616334283,1,1052,1053
SRR25023303_1_val_1_bismark_bt2_pe.bismark.cov,cases,chr11,108093371,108093371,0.341296928327645,3,876,879
SRR25023303_1_val_1_bismark_bt2_pe.bismark.cov,cases,chr11,108093373,108093373,0.0,0,878,878
SRR25023303_1_val_1_bismark_bt2_pe.bismark.cov,cases,chr11,108093386,108093386,0.455062571103527,4,875,879
SRR25023303_1_val_1_bismark_bt2_pe.bismark.cov,cases,chr11,108093395,108093395,0.11454753722795,1,872,873
SRR25023303_1_val_1_bismark_bt2_pe.bismark.cov,cases,chr11,108093402,108093402,0.345224395857307,3,866,869
SRR25023303_1_val_1_bismark_bt2_pe.bismark.cov,cases,chr11,108093413,108093413,0.348837209302326,3,857,860
SRR25023303_1_val_1_bismark_bt2_pe.bismark.cov,cases,chr11,108093419,108093419,0.0,0,860,860
SRR25023303_1_val_1_bismark_bt2_pe.bismark.cov,cases,chr11,108093436,108093436,0.466200466200466,4,854,858
SRR25023303_1_val_1_bismark_bt2_pe.bismark.cov,cases,chr11,108093439,108093439,0.0,0,860,860
SRR25023303_1_val_1_bismark_bt2_pe.bismark.cov,cases,chr11,108093451,108093451,0.0,0,858,858
SRR25023303_1_val_1_bismark_bt2_pe.bismark.cov,cases,chr11,108093457,108093457,0.233372228704784,2,855,857
SRR25023303_1_val_1_bismark_bt2_pe.bismark.cov,cases,chr11,108093461,108093461,0.699300699300699,6,852,858
SRR25023303_1_val_1_bismark_bt2_pe.bismark.cov,cases,chr11,108093467,108093467,0.0,0,857,857
SRR25023303_1_val_1_bismark_bt2_pe.bismark.cov,cases,chr11,108093476,108093476,0.234192037470726,2,852,854
SRR25023303_1_val_1_bismark_bt2_pe.bismark.cov,cases,chr11,108093485,108093485,0.235571260306243,2,847,849
SRR25023303_1_val_1_bismark_bt2_pe.bismark.cov,cases,chr11,108093505,108093505,0.127226463104326,1,785,786
SRR25023303_1_val_1_bismark_bt2_pe.bismark.cov,cases,chr11,108093520,108093520,0.0,0,631,631
SRR25023303_1_val_1_bismark_bt2_pe.bismark.cov,cases,chr11,108093529,108093529,1.75438596491228,1,56,57
SRR25023303_1_val_1_bismark_bt2_pe.bismark.cov,cases,chr11,108093532,108093532,1.49253731343284,1,66,67
SRR25023303_1_val_1_bismark_bt2_pe.bismark.cov,cases,chr11,108093538,108093538,1.03092783505155,1,96,97
SRR25023303_1_val_1_bismark_bt2_pe.bismark.cov,cases,chr11,108093560,108093560,0.296296296296296,2,673,675
SRR25023303_1_val_1_bismark_bt2_pe.bismark.cov,cases,chr11,108093567,108093567,0.0,0,721,721
SRR25023303_1_val_1_bismark_bt2_pe.bismark.cov,cases,chr11,108093572,108093572,0.0,0,750,750
SRR25023303_1_val_1_bismark_bt2_pe.bismark.cov,cases,chr11,108093579,108093579,0.0,0,769,769
SRR25023303_1_val_1_bismark_bt2_pe.bismark.cov,cases,chr11,108093584,108093584,0.378787878787879,3,789,792
SRR25023303_1_val_1_bismark_bt2_pe.bismark.cov,cases,chr11,108093590,108093590,0.0,0,843,843
SRR25023303_1_val_1_bismark_bt2_pe.bismark.cov,cases,chr11,108093598,108093598,0.582750582750583,5,853,858
SRR25023303_1_val_1_bismark_bt2_pe.bismark.cov,cases,chr6,43543548,43543548,0.869565217391304,4,456,460
SRR25023303_1_val_1_bismark_bt2_pe.bismark.cov,cases,chr6,43543554,43543554,0.434782608695652,2,458,460
SRR25023303_1_val_1_bismark_bt2_pe.bismark.cov,cases,chr6,43543571,43543571,0.437636761487965,2,455,457
SRR25023303_1_val_1_bismark_bt2_pe.bismark.cov,cases,chr6,43543578,43543578,0.433839479392625,2,459,461
SRR25023303_1_val_1_bismark_bt2_pe.bismark.cov,cases,chr6,43543580,43543580,0.217864923747277,1,458,459
SRR25023303_1_val_1_bismark_bt2_pe.bismark.cov,cases,chr6,43543596,43543596,0.0,0,460,460
SRR25023303_1_val_1_bismark_bt2_pe.bismark.cov,cases,chr6,43543608,43543608,0.216919739696312,1,460,461
SRR25023303_1_val_1_bismark_bt2_pe.bismark.cov,cases,chr6,43543613,43543613,0.650759219088937,3,458,461
SRR25023303_1_val_1_bismark_bt2_pe.bismark.cov,cases,chr6,43543615,43543615,0.433839479392625,2,459,461
SRR25023303_1_val_1_bismark_bt2_pe.bismark.cov,cases,chr6,43543618,43543618,0.0,0,460,460
SRR25023303_1_val_1_bismark_bt2_pe.bismark.cov,cases,chr6,43543624,43543624,1.31004366812227,6,452,458
SRR25023303_1_val_1_bismark_bt2_pe.bismark.cov,cases,chr6,43543642,43543642,0.0,0,459,459
SRR25023303_1_val_1_bismark_bt2_pe.bismark.cov,cases,chr6,43543650,43543650,0.0,0,457,457
SRR25023303_1_val_1_bismark_bt2_pe.bismark.cov,cases,chr6,43543657,43543657,0.655021834061135,3,455,458
SRR25023303_1_val_1_bismark_bt2_pe.bismark.cov,cases,chr6,43543669,43543669,0.0,0,458,458
SRR25023303_1_val_1_bismark_bt2_pe.bismark.cov,cases,chr6,43543672,43543672,0.66079295154185,3,451,454
SRR25023303_1_val_1_bismark_bt2_pe.bismark.cov,cases,chr6,43543682,43543682,0.222222222222222,1,449,450
SRR25023303_1_val_1_bismark_bt2_pe.bismark.cov,cases,chr6,43543691,43543691,0.89086859688196,4,445,449
SRR25023303_1_val_1_bismark_bt2_pe.bismark.cov,cases,chr6,43543696,43543696,1.78571428571429,8,440,448
SRR25023303_1_val_1_bismark_bt2_pe.bismark.cov,cases,chr6,43543698,43543698,0.447427293064877,2,445,447
SRR25023303_1_val_1_bismark_bt2_pe.bismark.cov,cases,chr6,43543701,43543701,1.12612612612613,5,439,444
SRR25023303_1_val_1_bismark_bt2_pe.bismark.cov,cases,chr6,43543705,43543705,0.224719101123596,1,444,445
SRR25023303_1_val_1_bismark_bt2_pe.bismark.cov,cases,chr6,43543708,43543708,0.225225225225225,1,443,444
SRR25023303_1_val_1_bismark_bt2_pe.bismark.cov,cases,chr6,43543733,43543733,0.0,0,446,446
SRR25023303_1_val_1_bismark_bt2_pe.bismark.cov,cases,chr6,43543747,43543747,0.223214285714286,1,447,448
SRR25023303_1_val_1_bismark_bt2_pe.bismark.cov,cases,chr6,43543749,43543749,0.669642857142857,3,445,448
SRR25023303_1_val_1_bismark_bt2_pe.bismark.cov,cases,chr6,43543763,43543763,0.464037122969838,2,429,431
SRR25023303_1_val_1_bismark_bt2_pe.bismark.cov,cases,chr6,43543766,43543766,0.0,0,427,427
SRR25023303_1_val_1_bismark_bt2_pe.bismark.cov,cases,chr6,43543771,43543771,0.0,0,435,435
SRR25023303_1_val_1_bismark_bt2_pe.bismark.cov,cases,chr6,43543775,43543775,0.464037122969838,2,429,431
SRR25023303_1_val_1_bismark_bt2_pe.bismark.cov,cases,chr6,43543777,43543777,0.466200466200466,2,427,429
SRR25023303_1_val_1_bismark_bt2_pe.bismark.cov,cases,chr6,43543781,43543781,0.232018561484919,1,430,431
SRR25023303_1_val_1_bismark_bt2_pe.bismark.cov,cases,chr6,43543786,43543786,0.229885057471264,1,434,435
SRR25023303_1_val_1_bismark_bt2_pe.bismark.cov,cases,chr6,43543794,43543794,0.455580865603645,2,437,439
SRR25023303_1_val_1_bismark_bt2_pe.bismark.cov,cases,chr6,43543798,43543798,0.681818181818182,3,437,440
SRR25023303_1_val_1_bismark_bt2_pe.bismark.cov,cases,chr6,43543800,43543800,0.226757369614512,1,440,441
SRR25023303_1_val_1_bismark_bt2_pe.bismark.cov,cases,chr6,43543804,43543804,0.451467268623025,2,441,443
SRR25023303_1_val_1_bismark_bt2_pe.bismark.cov,cases,chr6,43543806,43543806,0.451467268623025,2,441,443
SRR25023303_1_val_1_bismark_bt2_pe.bismark.cov,cases,chr6,43543815,43543815,0.0,0,441,441
SRR25023303_1_val_1_bismark_bt2_pe.bismark.cov,cases,chr6,43543822,43543822,0.452488687782805,2,440,442
SRR25023303_1_val_1_bismark_bt2_pe.bismark.cov,cases,chr2,47596828,47596828,3.6073329390893,61,1630,1691
SRR25023303_1_val_1_bismark_bt2_pe.bismark.cov,cases,chr2,47596830,47596830,4.60104834012813,79,1638,1717
SRR25023303_1_val_1_bismark_bt2_pe.bismark.cov,cases,chr2,47596840,47596840,4.30232558139535,74,1646,1720
SRR25023303_1_val_1_bismark_bt2_pe.bismark.cov,cases,chr2,47596849,47596849,21.9058686809994,377,1344,1721
SRR25023303_1_val_1_bismark_bt2_pe.bismark.cov,cases,chr2,47596853,47596853,6.63176265270506,114,1605,1719
SRR25023303_1_val_1_bismark_bt2_pe.bismark.cov,cases,chr2,47596858,47596858,10.9112013929193,188,1535,1723
SRR25023303_1_val_1_bismark_bt2_pe.bismark.cov,cases,chr2,47596862,47596862,10.68524970964,184,1538,1722
SRR25023303_1_val_1_bismark_bt2_pe.bismark.cov,cases,chr2,47596869,47596869,25.2753623188406,436,1289,1725
SRR25023303_1_val_1_bismark_bt2_pe.bismark.cov,cases,chr2,47596883,47596883,18.4561810795125,318,1405,1723
SRR25023303_1_val_1_bismark_bt2_pe.bismark.cov,cases,chr2,47596885,47596885,2.84552845528455,49,1673,1722
SRR25023303_1_val_1_bismark_bt2_pe.bismark.cov,cases,chr2,47596887,47596887,6.38051044083527,110,1614,1724
SRR25023303_1_val_1_bismark_bt2_pe.bismark.cov,cases,chr2,47596897,47596897,6.14492753623188,106,1619,1725
SRR25023303_1_val_1_bismark_bt2_pe.bismark.cov,cases,chr2,47596900,47596900,4.41603718768158,76,1645,1721
SRR25023303_1_val_1_bismark_bt2_pe.bismark.cov,cases,chr2,47596907,47596907,2.20801859384079,38,1683,1721
SRR25023303_1_val_1_bismark_bt2_pe.bismark.cov,cases,chr2,47596912,47596912,3.37013364323068,58,1663,1721
SRR25023303_1_val_1_bismark_bt2_pe.bismark.cov,cases,chr2,47596930,47596930,6.96864111498258,120,1602,1722
SRR25023303_1_val_1_bismark_bt2_pe.bismark.cov,cases,chr2,47596942,47596942,6.28637951105937,108,1610,1718
SRR25023303_1_val_1_bismark_bt2_pe.bismark.cov,cases,chr2,47630224,47630224,0.795947901591896,11,1371,1382
SRR25023303_1_val_1_bismark_bt2_pe.bismark.cov,cases,chr2,47630227,47630227,0.425531914893617,6,1404,1410
SRR25023303_1_val_1_bismark_bt2_pe.bismark.cov,cases,chr2,47630233,47630233,0.496102055279943,7,1404,1411
SRR25023303_1_val_1_bismark_bt2_pe.bismark.cov,cases,chr2,47630237,47630237,0.283687943262411,4,1406,1410
SRR25023303_1_val_1_bismark_bt2_pe.bismark.cov,cases,chr2,47630240,47630240,0.283687943262411,4,1406,1410
SRR25023303_1_val_1_bismark_bt2_pe.bismark.cov,cases,chr2,47630244,47630244,0.568585643212509,8,1399,1407
SRR25023303_1_val_1_bismark_bt2_pe.bismark.cov,cases,chr2,47630251,47630251,0.283687943262411,4,1406,1410
SRR25023303_1_val_1_bismark_bt2_pe.bismark.cov,cases,chr2,47630265,47630265,0.497866287339972,7,1399,1406
SRR25023303_1_val_1_bismark_bt2_pe.bismark.cov,cases,chr2,47630292,47630292,0.354358610914245,5,1406,1411
SRR25023303_1_val_1_bismark_bt2_pe.bismark.cov,cases,chr2,47630294,47630294,0.141743444365698,2,1409,1411
SRR25023303_1_val_1_bismark_bt2_pe.bismark.cov,cases,chr2,128051674,128051674,0.0,0,268,268
SRR25023303_1_val_1_bismark_bt2_pe.bismark.cov,cases,chr2,128051690,128051690,0.440528634361234,4,904,908
SRR25023303_1_val_1_bismark_bt2_pe.bismark.cov,cases,chr2,128051704,128051704,0.110253583241455,1,906,907
SRR25023303_1_val_1_bismark_bt2_pe.bismark.cov,cases,chr2,128051707,128051707,0.110497237569061,1,904,905
SRR25023303_1_val_1_bismark_bt2_pe.bismark.cov,cases,chr2,128051709,128051709,0.441501103752759,4,902,906
SRR25023303_1_val_1_bismark_bt2_pe.bismark.cov,cases,chr2,128051716,128051716,0.0,0,904,904
SRR25023303_1_val_1_bismark_bt2_pe.bismark.cov,cases,chr2,128051733,128051733,0.220507166482911,2,905,907
SRR25023303_1_val_1_bismark_bt2_pe.bismark.cov,cases,chr2,128051743,128051743,0.66079295154185,6,902,908
SRR25023303_1_val_1_bismark_bt2_pe.bismark.cov,cases,chr2,178787742,178787742,93.9890710382514,516,33,549
SRR25023303_1_val_1_bismark_bt2_pe.bismark.cov,cases,chr10,89619506,89619506,96.9230769230769,1386,44,1430
SRR25023303_1_val_1_bismark_bt2_pe.bismark.cov,cases,chr10,89619510,89619510,98.6043265875785,1413,20,1433
SRR25023303_1_val_1_bismark_bt2_pe.bismark.cov,cases,chr10,89619512,89619512,98.1171548117155,1407,27,1434
SRR25023303_1_val_1_bismark_bt2_pe.bismark.cov,cases,chr10,89619522,89619522,97.7793199167245,1409,32,1441
SRR25023303_1_val_1_bismark_bt2_pe.bismark.cov,cases,chr10,89619550,89619550,96.7315716272601,1391,47,1438
SRR25023303_1_val_1_bismark_bt2_pe.bismark.cov,cases,chr10,89619555,89619555,96.3863794301598,1387,52,1439
SRR25023303_1_val_1_bismark_bt2_pe.bismark.cov,cases,chr10,89619566,89619566,94.8503827418233,1363,74,1437
SRR25023303_1_val_1_bismark_bt2_pe.bismark.cov,cases,chr10,89619580,89619580,92.8122819260293,1330,103,1433
SRR25023303_1_val_1_bismark_bt2_pe.bismark.cov,cases,chr15,89786999,89786999,0.48780487804878,1,204,205
SRR25023303_1_val_1_bismark_bt2_pe.bismark.cov,cases,chr15,89787007,89787007,0.956937799043062,2,207,209
SRR25023303_1_val_1_bismark_bt2_pe.bismark.cov,cases,chr15,89787009,89787009,0.478468899521531,1,208,209
SRR25023303_1_val_1_bismark_bt2_pe.bismark.cov,cases,chr15,89787018,89787018,0.0,0,210,210
SRR25023303_1_val_1_bismark_bt2_pe.bismark.cov,cases,chr15,89787032,89787032,0.476190476190476,1,209,210
SRR25023303_1_val_1_bismark_bt2_pe.bismark.cov,cases,chr15,89787034,89787034,0.476190476190476,1,209,210
SRR25023303_1_val_1_bismark_bt2_pe.bismark.cov,cases,chr15,89787036,89787036,0.476190476190476,1,209,210
SRR25023303_1_val_1_bismark_bt2_pe.bismark.cov,cases,chr15,89787045,89787045,0.478468899521531,1,208,209
SRR25023303_1_val_1_bismark_bt2_pe.bismark.cov,cases,chr15,89787048,89787048,0.952380952380952,2,208,210
SRR25023303_1_val_1_bismark_bt2_pe.bismark.cov,cases,chr15,89787058,89787058,0.478468899521531,1,208,209
SRR25023303_1_val_1_bismark_bt2_pe.bismark.cov,cases,chr15,89787060,89787060,0.476190476190476,1,209,210
SRR25023303_1_val_1_bismark_bt2_pe.bismark.cov,cases,chr15,89787066,89787066,0.0,0,210,210
SRR25023303_1_val_1_bismark_bt2_pe.bismark.cov,cases,chr15,89787077,89787077,0.478468899521531,1,208,209
SRR25023303_1_val_1_bismark_bt2_pe.bismark.cov,cases,chr15,89787087,89787087,0.0,0,209,209
SRR25023303_1_val_1_bismark_bt2_pe.bismark.cov,cases,chr15,89787103,89787103,0.0,0,208,208
SRR25023303_1_val_1_bismark_bt2_pe.bismark.cov,cases,chr15,89787109,89787109,0.0,0,206,206
SRR25023303_1_val_1_bismark_bt2_pe.bismark.cov,cases,chr15,89787113,89787113,0.970873786407767,2,204,206
SRR25023303_1_val_1_bismark_bt2_pe.bismark.cov,cases,chr15,89787120,89787120,0.0,0,205,205
SRR25023303_1_val_1_bismark_bt2_pe.bismark.cov,cases,chr15,89787150,89787150,0.0,0,203,203
SRR25023303_1_val_1_bismark_bt2_pe.bismark.cov,cases,chr15,89787154,89787154,0.492610837438424,1,202,203
SRR25023303_1_val_1_bismark_bt2_pe.bismark.cov,cases,chr15,89787164,89787164,0.0,0,198,198
SRR25023303_1_val_1_bismark_bt2_pe.bismark.cov,cases,chr15,89787168,89787168,0.505050505050505,1,197,198
SRR25023303_1_val_1_bismark_bt2_pe.bismark.cov,cases,chr15,89787171,89787171,0.50761421319797,1,196,197
SRR25023303_1_val_1_bismark_bt2_pe.bismark.cov,cases,chr15,89787182,89787182,0.0,0,193,193
SRR25023303_1_val_1_bismark_bt2_pe.bismark.cov,cases,chr15,89787184,89787184,0.0,0,191,191
SRR25023303_1_val_1_bismark_bt2_pe.bismark.cov,cases,chr15,89787190,89787190,0.540540540540541,1,184,185
SRR25023303_1_val_1_bismark_bt2_pe.bismark.cov,cases,chr15,89787205,89787205,0.0,0,170,170
SRR25023303_1_val_1_bismark_bt2_pe.bismark.cov,cases,chr15,89787212,89787212,0.0,0,127,127
SRR25023303_1_val_1_bismark_bt2_pe.bismark.cov,cases,chr15,89787223,89787223,0.0,0,97,97
SRR25023303_1_val_1_bismark_bt2_pe.bismark.cov,cases,chr15,89787226,89787226,0.0,0,95,95
SRR25023303_1_val_1_bismark_bt2_pe.bismark.cov,cases,chr15,89787238,89787238,0.0,0,111,111
SRR25023303_1_val_1_bismark_bt2_pe.bismark.cov,cases,chr15,89787260,89787260,0.0,0,140,140
SRR25023303_1_val_1_bismark_bt2_pe.bismark.cov,cases,chr15,89787272,89787272,0.0,0,147,147
SRR25023303_1_val_1_bismark_bt2_pe.bismark.cov,cases,chr15,89787288,89787288,0.602409638554217,1,165,166
SRR25023303_1_val_1_bismark_bt2_pe.bismark.cov,cases,chr15,89787293,89787293,0.0,0,176,176
SRR25023303_1_val_1_bismark_bt2_pe.bismark.cov,cases,chr15,89787295,89787295,0.0,0,178,178
SRR25023303_1_val_1_bismark_bt2_pe.bismark.cov,cases,chr15,89787304,89787304,0.540540540540541,1,184,185
SRR25023303_1_val_1_bismark_bt2_pe.bismark.cov,cases,chr15,89787335,89787335,1.03092783505155,2,192,194
SRR25023303_1_val_1_bismark_bt2_pe.bismark.cov,cases,chr8,30890012,30890012,59.4871794871795,348,237,585
SRR25023303_1_val_1_bismark_bt2_pe.bismark.cov,cases,chr8,30890034,30890034,63.9032815198618,370,209,579
SRR25023303_1_val_1_bismark_bt2_pe.bismark.cov,cases,chr8,30890051,30890051,96.1538461538462,550,22,572
SRR25023303_1_val_1_bismark_bt2_pe.bismark.cov,cases,chr8,30890057,30890057,78.6339754816112,449,122,571
SRR25023303_1_val_1_bismark_bt2_pe.bismark.cov,cases,chr8,30890073,30890073,40.8376963350785,234,339,573
SRR25023303_1_val_1_bismark_bt2_pe.bismark.cov,cases,chr8,30890108,30890108,12.1052631578947,69,501,570
SRR25023303_1_val_1_bismark_bt2_pe.bismark.cov,cases,chr8,30890133,30890133,24.6527777777778,142,434,576
SRR25023303_1_val_1_bismark_bt2_pe.bismark.cov,cases,chr8,30890139,30890139,43.4782608695652,250,325,575
SRR25023303_1_val_1_bismark_bt2_pe.bismark.cov,cases,chr8,30890145,30890145,9.58188153310105,55,519,574
SRR25023303_1_val_1_bismark_bt2_pe.bismark.cov,cases,chr8,30890170,30890170,16.2872154115587,93,478,571
SRR25023303_1_val_1_bismark_bt2_pe.bismark.cov,cases,chr8,30890172,30890172,11.0526315789474,63,507,570
SRR25023303_1_val_1_bismark_bt2_pe.bismark.cov,cases,chr8,90997245,90997245,24.8275862068966,36,109,145
SRR25023303_1_val_1_bismark_bt2_pe.bismark.cov,cases,chr8,90997299,90997299,0.0,0,136,136
SRR25023303_1_val_1_bismark_bt2_pe.bismark.cov,cases,chr8,90997454,90997454,21.4285714285714,27,99,126
SRR25023303_1_val_1_bismark_bt2_pe.bismark.cov,cases,chr8,90997482,90997482,95.2755905511811,121,6,127
SRR25023303_1_val_1_bismark_bt2_pe.bismark.cov,cases,chr14,45604787,45604787,0.0,0,364,364
SRR25023303_1_val_1_bismark_bt2_pe.bismark.cov,cases,chr14,45604794,45604794,0.550964187327824,2,361,363
SRR25023303_1_val_1_bismark_bt2_pe.bismark.cov,cases,chr7,6048869,6048869,0.49306625577812,16,3229,3245
SRR25023303_1_val_1_bismark_bt2_pe.bismark.cov,cases,chr7,6048876,6048876,0.338878619839803,11,3235,3246
SRR25023303_1_val_1_bismark_bt2_pe.bismark.cov,cases,chr7,6048884,6048884,0.308832612723904,10,3228,3238
SRR25023303_1_val_1_bismark_bt2_pe.bismark.cov,cases,chr7,6048888,6048888,0.247218788627936,8,3228,3236
SRR25023303_1_val_1_bismark_bt2_pe.bismark.cov,cases,chr7,6048892,6048892,0.401606425702811,13,3224,3237
SRR25023303_1_val_1_bismark_bt2_pe.bismark.cov,cases,chr7,6048904,6048904,0.0,0,620,620
SRR25023303_1_val_1_bismark_bt2_pe.bismark.cov,cases,chr7,6048918,6048918,0.154273372415921,5,3236,3241
SRR25023303_1_val_1_bismark_bt2_pe.bismark.cov,cases,chr7,6048925,6048925,0.215982721382289,7,3234,3241
SRR25023303_1_val_1_bismark_bt2_pe.bismark.cov,cases,chr7,6048928,6048928,0.585516178736518,19,3226,3245
SRR25023303_1_val_1_bismark_bt2_pe.bismark.cov,cases,chr7,6048940,6048940,0.30826140567201,10,3234,3244
SRR25023303_1_val_1_bismark_bt2_pe.bismark.cov,cases,chr7,6048951,6048951,0.154225786551511,5,3237,3242
SRR25023303_1_val_1_bismark_bt2_pe.bismark.cov,cases,chr7,6048966,6048966,0.308356460067838,10,3233,3243
SRR25023303_1_val_1_bismark_bt2_pe.bismark.cov,cases,chr7,6048968,6048968,0.403225806451613,13,3211,3224
SRR25023303_1_val_1_bismark_bt2_pe.bismark.cov,cases,chr17,41277106,41277106,0.899031811894882,13,1433,1446
SRR25023303_1_val_1_bismark_bt2_pe.bismark.cov,cases,chr17,41277115,41277115,0.276052449965493,4,1445,1449
SRR25023303_1_val_1_bismark_bt2_pe.bismark.cov,cases,chr17,41277117,41277117,0.41522491349481,6,1439,1445
SRR25023303_1_val_1_bismark_bt2_pe.bismark.cov,cases,chr17,41277153,41277153,0.414364640883978,6,1442,1448
SRR25023303_1_val_1_bismark_bt2_pe.bismark.cov,cases,chr17,41277160,41277160,0.34435261707989,5,1447,1452
SRR25023303_1_val_1_bismark_bt2_pe.bismark.cov,cases,chr17,41277174,41277174,0.275482093663912,4,1448,1452
SRR25023303_1_val_1_bismark_bt2_pe.bismark.cov,cases,chr17,41277187,41277187,3.29593267882188,47,1379,1426
SRR25023303_1_val_1_bismark_bt2_pe.bismark.cov,cases,chr17,41277214,41277214,0.207182320441989,3,1445,1448
SRR25023303_1_val_1_bismark_bt2_pe.bismark.cov,cases,chr17,41277232,41277232,0.343170899107756,5,1452,1457
SRR25023303_1_val_1_bismark_bt2_pe.bismark.cov,cases,chr17,56769746,56769746,85.4922279792746,165,28,193
SRR25023303_1_val_1_bismark_bt2_pe.bismark.cov,cases,chr17,56769760,56769760,85.7142857142857,168,28,196
SRR25023303_1_val_1_bismark_bt2_pe.bismark.cov,cases,chr17,56769767,56769767,64.7959183673469,127,69,196
SRR25023303_1_val_1_bismark_bt2_pe.bismark.cov,cases,chr17,56769830,56769830,2.63157894736842,5,185,190
SRR25023303_1_val_1_bismark_bt2_pe.bismark.cov,cases,chr17,56769866,56769866,1.57894736842105,3,187,190
SRR25023303_1_val_1_bismark_bt2_pe.bismark.cov,cases,chr17,56769883,56769883,1.05263157894737,2,188,190
SRR25023303_1_val_1_bismark_bt2_pe.bismark.cov,cases,chr17,56769891,56769891,2.10526315789474,4,186,190
SRR25023303_1_val_1_bismark_bt2_pe.bismark.cov,cases,chr17,56769895,56769895,1.05820105820106,2,187,189
SRR25023303_1_val_1_bismark_bt2_pe.bismark.cov,cases,chr17,56769904,56769904,1.06382978723404,2,186,188
SRR25023303_1_val_1_bismark_bt2_pe.bismark.cov,cases,chr17,56769912,56769912,1.05820105820106,2,187,189
SRR25023303_1_val_1_bismark_bt2_pe.bismark.cov,cases,chr17,56769922,56769922,1.05263157894737,2,188,190
SRR25023303_1_val_1_bismark_bt2_pe.bismark.cov,cases,chr17,56769929,56769929,1.05820105820106,2,187,189
SRR25023303_1_val_1_bismark_bt2_pe.bismark.cov,cases,chr17,56769936,56769936,0.0,0,185,185
SRR25023303_1_val_1_bismark_bt2_pe.bismark.cov,cases,chr17,56769941,56769941,0.0,0,185,185
SRR25023303_1_val_1_bismark_bt2_pe.bismark.cov,cases,chr17,56769944,56769944,0.537634408602151,1,185,186
SRR25023303_1_val_1_bismark_bt2_pe.bismark.cov,cases,chr17,56769948,56769948,0.0,0,183,183
SRR25023303_1_val_1_bismark_bt2_pe.bismark.cov,cases,chr17,56769956,56769956,0.0,0,170,170
SRR25023303_1_val_1_bismark_bt2_pe.bismark.cov,cases,chr17,56769962,56769962,0.0,0,161,161
SRR25023303_1_val_1_bismark_bt2_pe.bismark.cov,cases,chr17,56769966,56769966,0.0,0,160,160
SRR25023303_1_val_1_bismark_bt2_pe.bismark.cov,cases,chr17,56769982,56769982,0.0,0,166,166
SRR25023303_1_val_1_bismark_bt2_pe.bismark.cov,cases,chr17,56770003,56770003,0.574712643678161,1,173,174
SRR25023303_1_val_1_bismark_bt2_pe.bismark.cov,cases,chr17,56770008,56770008,0.0,0,176,176
SRR25023303_1_val_1_bismark_bt2_pe.bismark.cov,cases,chr17,56770010,56770010,0.568181818181818,1,175,176
SRR25023303_1_val_1_bismark_bt2_pe.bismark.cov,cases,chr17,56770018,56770018,0.0,0,179,179
SRR25023303_1_val_1_bismark_bt2_pe.bismark.cov,cases,chr17,56770023,56770023,1.11111111111111,2,178,180
SRR25023303_1_val_1_bismark_bt2_pe.bismark.cov,cases,chr17,56770038,56770038,0.0,0,181,181
SRR25023303_1_val_1_bismark_bt2_pe.bismark.cov,cases,chr17,56770057,56770057,2.67379679144385,5,182,187
SRR25023303_1_val_1_bismark_bt2_pe.bismark.cov,cases,chr17,56770069,56770069,0.531914893617021,1,187,188
SRR25023303_1_val_1_bismark_bt2_pe.bismark.cov,cases,chr17,56770074,56770074,0.526315789473684,1,189,190
SRR25023303_1_val_1_bismark_bt2_pe.bismark.cov,cases,chr17,56770093,56770093,0.0,0,191,191
SRR25023303_1_val_1_bismark_bt2_pe.bismark.cov,cases,chr17,59940970,59940970,0.0,0,398,398
SRR25023303_1_val_1_bismark_bt2_pe.bismark.cov,cases,chr17,59940975,59940975,0.0,0,400,400
SRR25023303_1_val_1_bismark_bt2_pe.bismark.cov,cases,chr17,59940988,59940988,0.25062656641604,1,398,399
SRR25023303_1_val_1_bismark_bt2_pe.bismark.cov,cases,chr17,59940997,59940997,0.512820512820513,2,388,390
SRR25023303_1_val_1_bismark_bt2_pe.bismark.cov,cases,chr17,59941017,59941017,0.444444444444444,1,224,225
SRR25023303_1_val_1_bismark_bt2_pe.bismark.cov,cases,chr17,59941051,59941051,0.0,0,398,398
SRR25023303_1_val_1_bismark_bt2_pe.bismark.cov,cases,chr17,59941053,59941053,0.0,0,422,422
SRR25023303_1_val_1_bismark_bt2_pe.bismark.cov,cases,chr17,59941056,59941056,0.251889168765743,1,396,397
SRR25023303_1_val_1_bismark_bt2_pe.bismark.cov,cases,chr17,59941067,59941067,0.0,0,407,407
SRR25023303_1_val_1_bismark_bt2_pe.bismark.cov,cases,chr17,59941110,59941110,0.454545454545455,2,438,440
SRR25023303_1_val_1_bismark_bt2_pe.bismark.cov,cases,chr17,59941133,59941133,0.226757369614512,1,440,441
SRR25023303_1_val_1_bismark_bt2_pe.bismark.cov,cases,chr17,59941136,59941136,0.90702947845805,4,437,441
SRR25023303_1_val_1_bismark_bt2_pe.bismark.cov,cases,chr17,59941187,59941187,0.680272108843537,3,438,441
SRR25023303_1_val_1_bismark_bt2_pe.bismark.cov,cases,chr17,59941191,59941191,0.453514739229025,2,439,441
SRR25023303_1_val_1_bismark_bt2_pe.bismark.cov,cases,chr17,59941201,59941201,0.970873786407767,3,306,309
SRR25023303_1_val_1_bismark_bt2_pe.bismark.cov,cases,chr17,59941202,59941202,0.87719298245614,1,113,114
SRR25023303_1_val_1_bismark_bt2_pe.bismark.cov,cases,chr17,76325846,76325846,45.4545454545455,10,12,22
SRR25023303_1_val_1_bismark_bt2_pe.bismark.cov,cases,chr17,76325851,76325851,9.09090909090909,2,20,22
SRR25023303_1_val_1_bismark_bt2_pe.bismark.cov,cases,chr17,76325865,76325865,13.6363636363636,3,19,22
SRR25023303_1_val_1_bismark_bt2_pe.bismark.cov,cases,chr17,76325979,76325979,63.6363636363636,14,8,22
SRR25023303_1_val_1_bismark_bt2_pe.bismark.cov,cases,chr16,23652769,23652769,0.596125186289121,4,667,671
SRR25023303_1_val_1_bismark_bt2_pe.bismark.cov,cases,chr16,23652783,23652783,0.29673590504451,2,672,674
SRR25023303_1_val_1_bismark_bt2_pe.bismark.cov,cases,chr16,23652787,23652787,0.14903129657228,1,670,671
SRR25023303_1_val_1_bismark_bt2_pe.bismark.cov,cases,chr16,23652797,23652797,0.149476831091181,1,668,669
SRR25023303_1_val_1_bismark_bt2_pe.bismark.cov,cases,chr16,23652818,23652818,0.302114803625378,2,660,662
SRR25023303_1_val_1_bismark_bt2_pe.bismark.cov,cases,chr16,23652838,23652838,0.749625187406297,5,662,667
SRR25023303_1_val_1_bismark_bt2_pe.bismark.cov,cases,chr16,23652857,23652857,0.148588410104012,1,672,673
SRR25023303_1_val_1_bismark_bt2_pe.bismark.cov,cases,chr16,23652860,23652860,0.29585798816568,2,674,676
SRR25023303_1_val_1_bismark_bt2_pe.bismark.cov,cases,chr16,23652876,23652876,0.592592592592593,4,671,675
SRR25023303_1_val_1_bismark_bt2_pe.bismark.cov,cases,chr16,23652906,23652906,0.297176820208024,2,671,673
SRR25023303_1_val_1_bismark_bt2_pe.bismark.cov,cases,chr16,23652911,23652911,0.296296296296296,2,673,675
SRR25023303_1_val_1_bismark_bt2_pe.bismark.cov,cases,chr16,23652916,23652916,0.151515151515152,1,659,660
SRR25023303_1_val_1_bismark_bt2_pe.bismark.cov,cases,chr16,23652918,23652918,0.445103857566766,3,671,674
SRR25023303_1_val_1_bismark_bt2_pe.bismark.cov,cases,chrX,14891454,14891454,26.9201520912547,1416,3844,5260
SRR25023303_1_val_1_bismark_bt2_pe.bismark.cov,cases,chrX,14891470,14891470,24.5390610150162,1291,3970,5261
SRR25023303_1_val_1_bismark_bt2_pe.bismark.cov,cases,chrX,14891474,14891474,24.4545627015747,1289,3982,5271
SRR25023303_1_val_1_bismark_bt2_pe.bismark.cov,cases,chrX,14891488,14891488,21.0775943843673,1111,4160,5271
SRR25023303_1_val_1_bismark_bt2_pe.bismark.cov,cases,chrX,14891493,14891493,44.5182094081942,2347,2925,5272
SRR25023303_1_val_1_bismark_bt2_pe.bismark.cov,cases,chrX,14891496,14891496,34.8625592417062,1839,3436,5275
SRR25023303_1_val_1_bismark_bt2_pe.bismark.cov,cases,chrX,14891499,14891499,23.4010248624027,1233,4036,5269
SRR25023303_1_val_1_bismark_bt2_pe.bismark.cov,cases,chrX,14891509,14891509,38.2716049382716,2015,3250,5265
SRR25023303_1_val_1_bismark_bt2_pe.bismark.cov,cases,chrX,14891516,14891516,37.7727186492127,1991,3280,5271
SRR25023303_1_val_1_bismark_bt2_pe.bismark.cov,cases,chrX,14891524,14891524,26.636311895276,1404,3867,5271
SRR25023303_1_val_1_bismark_bt2_pe.bismark.cov,cases,chrX,14891526,14891526,27.2192716236722,1435,3837,5272
SRR25023303_1_val_1_bismark_bt2_pe.bismark.cov,cases,chrX,14891530,14891530,32.8332700341815,1729,3537,5266
SRR25023303_1_val_1_bismark_bt2_pe.bismark.cov,cases,chr22,29137950,29137950,0.0,0,67,67
SRR25023303_1_val_1_bismark_bt2_pe.bismark.cov,cases,chr22,29137964,29137964,0.0,0,50,50
SRR25023303_1_val_1_bismark_bt2_pe.bismark.cov,cases,chr22,29137975,29137975,0.0,0,33,33
SRR25023303_1_val_1_bismark_bt2_pe.bismark.cov,cases,chr22,29138031,29138031,0.0,0,70,70
SRR25023303_1_val_1_bismark_bt2_pe.bismark.cov,cases,chr22,29138052,29138052,0.0,0,73,73
SRR25023303_1_val_1_bismark_bt2_pe.bismark.cov,cases,chr22,29138062,29138062,0.0,0,75,75
SRR25023303_1_val_1_bismark_bt2_pe.bismark.cov,cases,chr22,29138075,29138075,0.0,0,73,73
SRR25023303_1_val_1_bismark_bt2_pe.bismark.cov,cases,chr22,29138078,29138078,0.0,0,74,74
SRR25023303_1_val_1_bismark_bt2_pe.bismark.cov,cases,chr22,29138091,29138091,0.0,0,69,69
SRR25023303_1_val_1_bismark_bt2_pe.bismark.cov,cases,chr22,29138102,29138102,1.31578947368421,1,75,76
SRR25023303_1_val_1_bismark_bt2_pe.bismark.cov,cases,chr22,29138115,29138115,0.0,0,77,77
SRR25023303_1_val_1_bismark_bt2_pe.bismark.cov,cases,chr22,29138134,29138134,0.0,0,77,77
SRR25023303_1_val_1_bismark_bt2_pe.bismark.cov,cases,chr22,29138158,29138158,0.0,0,80,80
SRR25023303_1_val_1_bismark_bt2_pe.bismark.cov,cases,chr22,29138168,29138168,0.0,0,82,82
SRR25023303_1_val_1_bismark_bt2_pe.bismark.cov,cases,chr22,29138176,29138176,0.0,0,82,82
SRR25023303_1_val_1_bismark_bt2_pe.bismark.cov,cases,chr22,29138179,29138179,0.0,0,84,84
SRR25023303_1_val_1_bismark_bt2_pe.bismark.cov,cases,chr22,29138185,29138185,1.13636363636364,1,87,88
SRR25023303_1_val_1_bismark_bt2_pe.bismark.cov,cases,chr22,29138202,29138202,0.0,0,88,88
SRR25023303_1_val_1_bismark_bt2_pe.bismark.cov,cases,chr22,29138216,29138216,2.24719101123596,2,87,89
SRR25023303_1_val_1_bismark_bt2_pe.bismark.cov,cases,chr22,29138219,29138219,0.0,0,89,89
SRR25023303_1_val_1_bismark_bt2_pe.bismark.cov,cases,chr22,29138234,29138234,0.0,0,89,89
SRR25023303_1_val_1_bismark_bt2_pe.bismark.cov,cases,chr22,29138238,29138238,0.0,0,89,89
SRR25023304_1_val_1_bismark_bt2_pe.bismark.cov,cases,chr10,89619506,89619506,97.7713178294574,1009,23,1032
SRR25023304_1_val_1_bismark_bt2_pe.bismark.cov,cases,chr10,89619510,89619510,98.3543078412391,1016,17,1033
SRR25023304_1_val_1_bismark_bt2_pe.bismark.cov,cases,chr10,89619512,89619512,98.743961352657,1022,13,1035
SRR25023304_1_val_1_bismark_bt2_pe.bismark.cov,cases,chr10,89619522,89619522,98.6538461538462,1026,14,1040
SRR25023304_1_val_1_bismark_bt2_pe.bismark.cov,cases,chr10,89619550,89619550,98.1730769230769,1021,19,1040
SRR25023304_1_val_1_bismark_bt2_pe.bismark.cov,cases,chr10,89619555,89619555,97.4038461538461,1013,27,1040
SRR25023304_1_val_1_bismark_bt2_pe.bismark.cov,cases,chr10,89619566,89619566,95.3801732435034,991,48,1039
SRR25023304_1_val_1_bismark_bt2_pe.bismark.cov,cases,chr10,89619580,89619580,91.5057915057915,948,88,1036
SRR25023304_1_val_1_bismark_bt2_pe.bismark.cov,cases,chr3,37034307,37034307,99.9261992619926,2708,2,2710
SRR25023304_1_val_1_bismark_bt2_pe.bismark.cov,cases,chr3,37034316,37034316,0.257637099742363,7,2710,2717
SRR25023304_1_val_1_bismark_bt2_pe.bismark.cov,cases,chr3,37034324,37034324,0.220994475138122,6,2709,2715
SRR25023304_1_val_1_bismark_bt2_pe.bismark.cov,cases,chr3,37034330,37034330,0.257542310522443,7,2711,2718
SRR25023304_1_val_1_bismark_bt2_pe.bismark.cov,cases,chr3,37034344,37034344,0.404560500183891,11,2708,2719
SRR25023304_1_val_1_bismark_bt2_pe.bismark.cov,cases,chr3,37034346,37034346,0.478645066273932,13,2703,2716
SRR25023304_1_val_1_bismark_bt2_pe.bismark.cov,cases,chr3,37034348,37034348,0.478468899521531,13,2704,2717
SRR25023304_1_val_1_bismark_bt2_pe.bismark.cov,cases,chr3,37034352,37034352,0.625,17,2703,2720
SRR25023304_1_val_1_bismark_bt2_pe.bismark.cov,cases,chr3,37034355,37034355,0.845588235294118,23,2697,2720
SRR25023304_1_val_1_bismark_bt2_pe.bismark.cov,cases,chr3,37034359,37034359,0.514705882352941,14,2706,2720
SRR25023304_1_val_1_bismark_bt2_pe.bismark.cov,cases,chr3,37034369,37034369,0.641993957703928,17,2631,2648
SRR25023304_1_val_1_bismark_bt2_pe.bismark.cov,cases,chr3,37034373,37034373,0.551267916207277,15,2706,2721
SRR25023304_1_val_1_bismark_bt2_pe.bismark.cov,cases,chr3,37034382,37034382,0.441014332965821,12,2709,2721
SRR25023304_1_val_1_bismark_bt2_pe.bismark.cov,cases,chr3,37034394,37034394,0.441014332965821,12,2709,2721
SRR25023304_1_val_1_bismark_bt2_pe.bismark.cov,cases,chr3,37034402,37034402,0.514516721793458,14,2707,2721
SRR25023304_1_val_1_bismark_bt2_pe.bismark.cov,cases,chr3,37034409,37034409,0.183621006243114,5,2718,2723
SRR25023304_1_val_1_bismark_bt2_pe.bismark.cov,cases,chr3,37034412,37034412,0.220426157237326,6,2716,2722
SRR25023304_1_val_1_bismark_bt2_pe.bismark.cov,cases,chr3,37034414,37034414,0.330882352941176,9,2711,2720
SRR25023304_1_val_1_bismark_bt2_pe.bismark.cov,cases,chr3,37034418,37034418,0.514516721793458,14,2707,2721
SRR25023304_1_val_1_bismark_bt2_pe.bismark.cov,cases,chr3,37034420,37034420,0.257447591026113,7,2712,2719
SRR25023304_1_val_1_bismark_bt2_pe.bismark.cov,cases,chr3,37034430,37034430,0.147275405007364,4,2712,2716
SRR25023304_1_val_1_bismark_bt2_pe.bismark.cov,cases,chr3,37034438,37034438,0.55207949944792,15,2702,2717
SRR25023304_1_val_1_bismark_bt2_pe.bismark.cov,cases,chr3,37034441,37034441,0.294767870302137,8,2706,2714
SRR25023304_1_val_1_bismark_bt2_pe.bismark.cov,cases,chr3,37034466,37034466,100.0,2710,0,2710
SRR25023304_1_val_1_bismark_bt2_pe.bismark.cov,cases,chr3,37034997,37034997,0.397515527950311,16,4009,4025
SRR25023304_1_val_1_bismark_bt2_pe.bismark.cov,cases,chr3,37035012,37035012,0.297766749379653,12,4018,4030
SRR25023304_1_val_1_bismark_bt2_pe.bismark.cov,cases,chr3,37035032,37035032,0.471698113207547,19,4009,4028
SRR25023304_1_val_1_bismark_bt2_pe.bismark.cov,cases,chr3,37035043,37035043,0.744601638123604,30,3999,4029
SRR25023304_1_val_1_bismark_bt2_pe.bismark.cov,cases,chr3,37035047,37035047,0.198412698412698,8,4024,4032
SRR25023304_1_val_1_bismark_bt2_pe.bismark.cov,cases,chr3,37035063,37035063,0.668482297598415,27,4012,4039
SRR25023304_1_val_1_bismark_bt2_pe.bismark.cov,cases,chr3,37035066,37035066,0.717821782178218,29,4011,4040
SRR25023304_1_val_1_bismark_bt2_pe.bismark.cov,cases,chr3,37035074,37035074,0.346878097125867,14,4022,4036
SRR25023304_1_val_1_bismark_bt2_pe.bismark.cov,cases,chr3,37035090,37035090,0.321782178217822,13,4027,4040
SRR25023304_1_val_1_bismark_bt2_pe.bismark.cov,cases,chr3,37035095,37035095,0.569729997522913,23,4014,4037
SRR25023304_1_val_1_bismark_bt2_pe.bismark.cov,cases,chr3,37035097,37035097,0.495049504950495,20,4020,4040
SRR25023304_1_val_1_bismark_bt2_pe.bismark.cov,cases,chr3,37035100,37035100,0.446096654275093,18,4017,4035
SRR25023304_1_val_1_bismark_bt2_pe.bismark.cov,cases,chr3,37035117,37035117,0.321782178217822,13,4027,4040
SRR25023304_1_val_1_bismark_bt2_pe.bismark.cov,cases,chr3,142297977,142297977,0.731895223420647,19,2577,2596
SRR25023304_1_val_1_bismark_bt2_pe.bismark.cov,cases,chr3,142298019,142298019,0.846805234795997,22,2576,2598
SRR25023304_1_val_1_bismark_bt2_pe.bismark.cov,cases,chr3,142298045,142298045,0.42421905129194,11,2582,2593
SRR25023304_1_val_1_bismark_bt2_pe.bismark.cov,cases,chr3,142298054,142298054,2.78637770897833,72,2512,2584
SRR25023304_1_val_1_bismark_bt2_pe.bismark.cov,cases,chr13,32889392,32889392,12.9623873173764,417,2800,3217
SRR25023304_1_val_1_bismark_bt2_pe.bismark.cov,cases,chr13,32889434,32889434,1.96567862714509,63,3142,3205
SRR25023304_1_val_1_bismark_bt2_pe.bismark.cov,cases,chr13,32889461,32889461,0.562675836198812,18,3181,3199
SRR25023304_1_val_1_bismark_bt2_pe.bismark.cov,cases,chr13,32889470,32889470,0.156201187129022,5,3196,3201
SRR25023304_1_val_1_bismark_bt2_pe.bismark.cov,cases,chr13,32889484,32889484,0.249687890137328,8,3196,3204
SRR25023304_1_val_1_bismark_bt2_pe.bismark.cov,cases,chr13,108867034,108867034,41.0703897614892,706,1013,1719
SRR25023304_1_val_1_bismark_bt2_pe.bismark.cov,cases,chr13,108867035,108867035,0.0,0,21,21
SRR25023304_1_val_1_bismark_bt2_pe.bismark.cov,cases,chr13,108867044,108867044,46.4490263459336,811,935,1746
SRR25023304_1_val_1_bismark_bt2_pe.bismark.cov,cases,chr13,108867051,108867051,49.7133027522936,867,877,1744
SRR25023304_1_val_1_bismark_bt2_pe.bismark.cov,cases,chr13,108867109,108867109,74.7722095671982,1313,443,1756
SRR25023304_1_val_1_bismark_bt2_pe.bismark.cov,cases,chr13,108867112,108867112,84.0637450199203,1477,280,1757
SRR25023304_1_val_1_bismark_bt2_pe.bismark.cov,cases,chr13,108867124,108867124,62.2006841505131,1091,663,1754
SRR25023304_1_val_1_bismark_bt2_pe.bismark.cov,cases,chr13,108867135,108867135,52.8538812785388,926,826,1752
SRR25023304_1_val_1_bismark_bt2_pe.bismark.cov,cases,chr13,108867155,108867155,45.5688965122927,797,952,1749
SRR25023304_1_val_1_bismark_bt2_pe.bismark.cov,cases,chr2,47596828,47596828,3.23809523809524,34,1016,1050
SRR25023304_1_val_1_bismark_bt2_pe.bismark.cov,cases,chr2,47596830,47596830,1.40449438202247,15,1053,1068
SRR25023304_1_val_1_bismark_bt2_pe.bismark.cov,cases,chr2,47596840,47596840,3.72786579683131,40,1033,1073
SRR25023304_1_val_1_bismark_bt2_pe.bismark.cov,cases,chr2,47596849,47596849,12.5815470643057,135,938,1073
SRR25023304_1_val_1_bismark_bt2_pe.bismark.cov,cases,chr2,47596853,47596853,2.52100840336134,27,1044,1071
SRR25023304_1_val_1_bismark_bt2_pe.bismark.cov,cases,chr2,47596858,47596858,5.8659217877095,63,1011,1074
SRR25023304_1_val_1_bismark_bt2_pe.bismark.cov,cases,chr2,47596862,47596862,6.70391061452514,72,1002,1074
SRR25023304_1_val_1_bismark_bt2_pe.bismark.cov,cases,chr2,47596869,47596869,15.828677839851,170,904,1074
SRR25023304_1_val_1_bismark_bt2_pe.bismark.cov,cases,chr2,47596883,47596883,9.45692883895131,101,967,1068
SRR25023304_1_val_1_bismark_bt2_pe.bismark.cov,cases,chr2,47596885,47596885,1.68224299065421,18,1052,1070
SRR25023304_1_val_1_bismark_bt2_pe.bismark.cov,cases,chr2,47596887,47596887,4.66853408029879,50,1021,1071
SRR25023304_1_val_1_bismark_bt2_pe.bismark.cov,cases,chr2,47596897,47596897,2.79850746268657,30,1042,1072
SRR25023304_1_val_1_bismark_bt2_pe.bismark.cov,cases,chr2,47596900,47596900,2.33426704014939,25,1046,1071
SRR25023304_1_val_1_bismark_bt2_pe.bismark.cov,cases,chr2,47596907,47596907,1.87793427230047,20,1045,1065
SRR25023304_1_val_1_bismark_bt2_pe.bismark.cov,cases,chr2,47596912,47596912,1.03383458646617,11,1053,1064
SRR25023304_1_val_1_bismark_bt2_pe.bismark.cov,cases,chr2,47596930,47596930,3.28638497652582,35,1030,1065
SRR25023304_1_val_1_bismark_bt2_pe.bismark.cov,cases,chr2,47596942,47596942,2.8116213683224,30,1037,1067
SRR25023304_1_val_1_bismark_bt2_pe.bismark.cov,cases,chr2,47630224,47630224,0.974025974025974,9,915,924
SRR25023304_1_val_1_bismark_bt2_pe.bismark.cov,cases,chr2,47630227,47630227,1.58730158730159,15,930,945
SRR25023304_1_val_1_bismark_bt2_pe.bismark.cov,cases,chr2,47630233,47630233,0.316789862724393,3,944,947
SRR25023304_1_val_1_bismark_bt2_pe.bismark.cov,cases,chr2,47630237,47630237,0.105708245243129,1,945,946
SRR25023304_1_val_1_bismark_bt2_pe.bismark.cov,cases,chr2,47630240,47630240,0.529661016949152,5,939,944
SRR25023304_1_val_1_bismark_bt2_pe.bismark.cov,cases,chr2,47630244,47630244,1.3771186440678,13,931,944
SRR25023304_1_val_1_bismark_bt2_pe.bismark.cov,cases,chr2,47630251,47630251,0.739957716701903,7,939,946
SRR25023304_1_val_1_bismark_bt2_pe.bismark.cov,cases,chr2,47630265,47630265,0.0,0,943,943
SRR25023304_1_val_1_bismark_bt2_pe.bismark.cov,cases,chr2,47630292,47630292,0.423728813559322,4,940,944
SRR25023304_1_val_1_bismark_bt2_pe.bismark.cov,cases,chr2,47630294,47630294,0.422832980972516,4,942,946
SRR25023304_1_val_1_bismark_bt2_pe.bismark.cov,cases,chr2,128051674,128051674,0.0,0,222,222
SRR25023304_1_val_1_bismark_bt2_pe.bismark.cov,cases,chr2,128051690,128051690,0.235294117647059,2,848,850
SRR25023304_1_val_1_bismark_bt2_pe.bismark.cov,cases,chr2,128051704,128051704,0.586854460093897,5,847,852
SRR25023304_1_val_1_bismark_bt2_pe.bismark.cov,cases,chr2,128051707,128051707,0.116959064327485,1,854,855
SRR25023304_1_val_1_bismark_bt2_pe.bismark.cov,cases,chr2,128051709,128051709,0.819672131147541,7,847,854
SRR25023304_1_val_1_bismark_bt2_pe.bismark.cov,cases,chr2,128051716,128051716,0.82256169212691,7,844,851
SRR25023304_1_val_1_bismark_bt2_pe.bismark.cov,cases,chr2,128051733,128051733,0.117370892018779,1,851,852
SRR25023304_1_val_1_bismark_bt2_pe.bismark.cov,cases,chr2,128051743,128051743,0.705882352941177,6,844,850
SRR25023304_1_val_1_bismark_bt2_pe.bismark.cov,cases,chr2,178787742,178787742,94.6257197696737,493,28,521
SRR25023304_1_val_1_bismark_bt2_pe.bismark.cov,cases,chr2,241151145,241151145,96.1538461538462,25,1,26
SRR25023304_1_val_1_bismark_bt2_pe.bismark.cov,cases,chr2,241151165,241151165,85.7142857142857,24,4,28
SRR25023304_1_val_1_bismark_bt2_pe.bismark.cov,cases,chr2,241151205,241151205,100.0,30,0,30
SRR25023304_1_val_1_bismark_bt2_pe.bismark.cov,cases,chr2,241151217,241151217,96.551724137931,28,1,29
SRR25023304_1_val_1_bismark_bt2_pe.bismark.cov,cases,chr2,241151277,241151277,0.0,0,23,23
SRR25023304_1_val_1_bismark_bt2_pe.bismark.cov,cases,chr8,30890012,30890012,62.5187406296852,417,250,667
SRR25023304_1_val_1_bismark_bt2_pe.bismark.cov,cases,chr8,30890034,30890034,63.5670731707317,417,239,656
SRR25023304_1_val_1_bismark_bt2_pe.bismark.cov,cases,chr8,30890051,30890051,95.2453987730061,621,31,652
SRR25023304_1_val_1_bismark_bt2_pe.bismark.cov,cases,chr8,30890057,30890057,78.680981595092,513,139,652
SRR25023304_1_val_1_bismark_bt2_pe.bismark.cov,cases,chr8,30890073,30890073,46.5437788018433,303,348,651
SRR25023304_1_val_1_bismark_bt2_pe.bismark.cov,cases,chr8,30890108,30890108,12.7158555729984,81,556,637
SRR25023304_1_val_1_bismark_bt2_pe.bismark.cov,cases,chr8,30890133,30890133,22.2047244094488,141,494,635
SRR25023304_1_val_1_bismark_bt2_pe.bismark.cov,cases,chr8,30890139,30890139,45.5259026687598,290,347,637
SRR25023304_1_val_1_bismark_bt2_pe.bismark.cov,cases,chr8,30890145,30890145,6.89655172413793,44,594,638
SRR25023304_1_val_1_bismark_bt2_pe.bismark.cov,cases,chr8,30890170,30890170,18.8976377952756,120,515,635
SRR25023304_1_val_1_bismark_bt2_pe.bismark.cov,cases,chr8,30890172,30890172,13.968253968254,88,542,630
SRR25023304_1_val_1_bismark_bt2_pe.bismark.cov,cases,chr8,90997245,90997245,22.2222222222222,16,56,72
SRR25023304_1_val_1_bismark_bt2_pe.bismark.cov,cases,chr8,90997299,90997299,1.42857142857143,1,69,70
SRR25023304_1_val_1_bismark_bt2_pe.bismark.cov,cases,chr8,90997454,90997454,31.25,20,44,64
SRR25023304_1_val_1_bismark_bt2_pe.bismark.cov,cases,chr8,90997482,90997482,100.0,63,0,63
SRR25023304_1_val_1_bismark_bt2_pe.bismark.cov,cases,chr15,89786999,89786999,3.125,4,124,128
SRR25023304_1_val_1_bismark_bt2_pe.bismark.cov,cases,chr15,89787007,89787007,0.0,0,133,133
SRR25023304_1_val_1_bismark_bt2_pe.bismark.cov,cases,chr15,89787009,89787009,0.757575757575758,1,131,132
SRR25023304_1_val_1_bismark_bt2_pe.bismark.cov,cases,chr15,89787018,89787018,0.0,0,133,133
SRR25023304_1_val_1_bismark_bt2_pe.bismark.cov,cases,chr15,89787032,89787032,2.29007633587786,3,128,131
SRR25023304_1_val_1_bismark_bt2_pe.bismark.cov,cases,chr15,89787034,89787034,0.0,0,131,131
SRR25023304_1_val_1_bismark_bt2_pe.bismark.cov,cases,chr15,89787036,89787036,0.0,0,131,131
SRR25023304_1_val_1_bismark_bt2_pe.bismark.cov,cases,chr15,89787045,89787045,0.0,0,130,130
SRR25023304_1_val_1_bismark_bt2_pe.bismark.cov,cases,chr15,89787048,89787048,0.0,0,131,131
SRR25023304_1_val_1_bismark_bt2_pe.bismark.cov,cases,chr15,89787058,89787058,0.769230769230769,1,129,130
SRR25023304_1_val_1_bismark_bt2_pe.bismark.cov,cases,chr15,89787060,89787060,0.769230769230769,1,129,130
SRR25023304_1_val_1_bismark_bt2_pe.bismark.cov,cases,chr15,89787066,89787066,0.769230769230769,1,129,130
SRR25023304_1_val_1_bismark_bt2_pe.bismark.cov,cases,chr15,89787077,89787077,0.0,0,130,130
SRR25023304_1_val_1_bismark_bt2_pe.bismark.cov,cases,chr15,89787087,89787087,3.125,4,124,128
SRR25023304_1_val_1_bismark_bt2_pe.bismark.cov,cases,chr15,89787103,89787103,0.0,0,127,127
SRR25023304_1_val_1_bismark_bt2_pe.bismark.cov,cases,chr15,89787109,89787109,0.78740157480315,1,126,127
SRR25023304_1_val_1_bismark_bt2_pe.bismark.cov,cases,chr15,89787113,89787113,0.793650793650794,1,125,126
SRR25023304_1_val_1_bismark_bt2_pe.bismark.cov,cases,chr15,89787120,89787120,0.0,0,126,126
SRR25023304_1_val_1_bismark_bt2_pe.bismark.cov,cases,chr15,89787150,89787150,0.806451612903226,1,123,124
SRR25023304_1_val_1_bismark_bt2_pe.bismark.cov,cases,chr15,89787154,89787154,0.0,0,124,124
SRR25023304_1_val_1_bismark_bt2_pe.bismark.cov,cases,chr15,89787164,89787164,1.63934426229508,2,120,122
SRR25023304_1_val_1_bismark_bt2_pe.bismark.cov,cases,chr15,89787168,89787168,0.0,0,118,118
SRR25023304_1_val_1_bismark_bt2_pe.bismark.cov,cases,chr15,89787171,89787171,0.0,0,118,118
SRR25023304_1_val_1_bismark_bt2_pe.bismark.cov,cases,chr15,89787182,89787182,0.862068965517241,1,115,116
SRR25023304_1_val_1_bismark_bt2_pe.bismark.cov,cases,chr15,89787184,89787184,0.0,0,116,116
SRR25023304_1_val_1_bismark_bt2_pe.bismark.cov,cases,chr15,89787190,89787190,0.0,0,114,114
SRR25023304_1_val_1_bismark_bt2_pe.bismark.cov,cases,chr15,89787205,89787205,0.0,0,110,110
SRR25023304_1_val_1_bismark_bt2_pe.bismark.cov,cases,chr15,89787212,89787212,0.0,0,94,94
SRR25023304_1_val_1_bismark_bt2_pe.bismark.cov,cases,chr15,89787223,89787223,0.0,0,72,72
SRR25023304_1_val_1_bismark_bt2_pe.bismark.cov,cases,chr15,89787226,89787226,0.0,0,70,70
SRR25023304_1_val_1_bismark_bt2_pe.bismark.cov,cases,chr15,89787238,89787238,0.0,0,78,78
SRR25023304_1_val_1_bismark_bt2_pe.bismark.cov,cases,chr15,89787260,89787260,1.13636363636364,1,87,88
SRR25023304_1_val_1_bismark_bt2_pe.bismark.cov,cases,chr15,89787272,89787272,1.0752688172043,1,92,93
SRR25023304_1_val_1_bismark_bt2_pe.bismark.cov,cases,chr15,89787288,89787288,2.77777777777778,3,105,108
SRR25023304_1_val_1_bismark_bt2_pe.bismark.cov,cases,chr15,89787293,89787293,0.0,0,112,112
SRR25023304_1_val_1_bismark_bt2_pe.bismark.cov,cases,chr15,89787295,89787295,0.884955752212389,1,112,113
SRR25023304_1_val_1_bismark_bt2_pe.bismark.cov,cases,chr15,89787304,89787304,0.0,0,116,116
SRR25023304_1_val_1_bismark_bt2_pe.bismark.cov,cases,chr15,89787335,89787335,0.793650793650794,1,125,126
SRR25023304_1_val_1_bismark_bt2_pe.bismark.cov,cases,chr11,108093323,108093323,1.06888361045131,9,833,842
SRR25023304_1_val_1_bismark_bt2_pe.bismark.cov,cases,chr11,108093335,108093335,0.118343195266272,1,844,845
SRR25023304_1_val_1_bismark_bt2_pe.bismark.cov,cases,chr11,108093338,108093338,0.355029585798817,3,842,845
SRR25023304_1_val_1_bismark_bt2_pe.bismark.cov,cases,chr11,108093359,108093359,0.599520383693046,5,829,834
SRR25023304_1_val_1_bismark_bt2_pe.bismark.cov,cases,chr11,108093371,108093371,1.94319880418535,13,656,669
SRR25023304_1_val_1_bismark_bt2_pe.bismark.cov,cases,chr11,108093373,108093373,0.298953662182362,2,667,669
SRR25023304_1_val_1_bismark_bt2_pe.bismark.cov,cases,chr11,108093386,108093386,0.148809523809524,1,671,672
SRR25023304_1_val_1_bismark_bt2_pe.bismark.cov,cases,chr11,108093395,108093395,0.446428571428571,3,669,672
SRR25023304_1_val_1_bismark_bt2_pe.bismark.cov,cases,chr11,108093402,108093402,1.05105105105105,7,659,666
SRR25023304_1_val_1_bismark_bt2_pe.bismark.cov,cases,chr11,108093413,108093413,0.451807228915663,3,661,664
SRR25023304_1_val_1_bismark_bt2_pe.bismark.cov,cases,chr11,108093419,108093419,0.602409638554217,4,660,664
SRR25023304_1_val_1_bismark_bt2_pe.bismark.cov,cases,chr11,108093436,108093436,0.151515151515152,1,659,660
SRR25023304_1_val_1_bismark_bt2_pe.bismark.cov,cases,chr11,108093439,108093439,0.757575757575758,5,655,660
SRR25023304_1_val_1_bismark_bt2_pe.bismark.cov,cases,chr11,108093451,108093451,0.303030303030303,2,658,660
SRR25023304_1_val_1_bismark_bt2_pe.bismark.cov,cases,chr11,108093457,108093457,0.606980273141123,4,655,659
SRR25023304_1_val_1_bismark_bt2_pe.bismark.cov,cases,chr11,108093461,108093461,0.0,0,660,660
SRR25023304_1_val_1_bismark_bt2_pe.bismark.cov,cases,chr11,108093467,108093467,0.909090909090909,6,654,660
SRR25023304_1_val_1_bismark_bt2_pe.bismark.cov,cases,chr11,108093476,108093476,0.758725341426404,5,654,659
SRR25023304_1_val_1_bismark_bt2_pe.bismark.cov,cases,chr11,108093485,108093485,0.153374233128834,1,651,652
SRR25023304_1_val_1_bismark_bt2_pe.bismark.cov,cases,chr11,108093505,108093505,1.81518151815182,11,595,606
SRR25023304_1_val_1_bismark_bt2_pe.bismark.cov,cases,chr11,108093520,108093520,0.0,0,506,506
SRR25023304_1_val_1_bismark_bt2_pe.bismark.cov,cases,chr11,108093529,108093529,0.0,0,91,91
SRR25023304_1_val_1_bismark_bt2_pe.bismark.cov,cases,chr11,108093532,108093532,0.0,0,111,111
SRR25023304_1_val_1_bismark_bt2_pe.bismark.cov,cases,chr11,108093538,108093538,0.0,0,139,139
SRR25023304_1_val_1_bismark_bt2_pe.bismark.cov,cases,chr11,108093560,108093560,0.545454545454546,3,547,550
SRR25023304_1_val_1_bismark_bt2_pe.bismark.cov,cases,chr11,108093567,108093567,0.345423143350604,2,577,579
SRR25023304_1_val_1_bismark_bt2_pe.bismark.cov,cases,chr11,108093572,108093572,0.505902192242833,3,590,593
SRR25023304_1_val_1_bismark_bt2_pe.bismark.cov,cases,chr11,108093579,108093579,0.661157024793388,4,601,605
SRR25023304_1_val_1_bismark_bt2_pe.bismark.cov,cases,chr11,108093584,108093584,0.0,0,626,626
SRR25023304_1_val_1_bismark_bt2_pe.bismark.cov,cases,chr11,108093590,108093590,0.153846153846154,1,649,650
SRR25023304_1_val_1_bismark_bt2_pe.bismark.cov,cases,chr11,108093598,108093598,0.151975683890578,1,657,658
SRR25023304_1_val_1_bismark_bt2_pe.bismark.cov,cases,chr17,13571583,13571583,90.4761904761905,19,2,21
SRR25023304_1_val_1_bismark_bt2_pe.bismark.cov,cases,chr17,13571613,13571613,90.4761904761905,19,2,21
SRR25023304_1_val_1_bismark_bt2_pe.bismark.cov,cases,chr17,41277106,41277106,0.525624178712221,8,1514,1522
SRR25023304_1_val_1_bismark_bt2_pe.bismark.cov,cases,chr17,41277115,41277115,0.26281208935611,4,1518,1522
SRR25023304_1_val_1_bismark_bt2_pe.bismark.cov,cases,chr17,41277117,41277117,1.11695137976347,17,1505,1522
SRR25023304_1_val_1_bismark_bt2_pe.bismark.cov,cases,chr17,41277153,41277153,0.595632031767042,9,1502,1511
SRR25023304_1_val_1_bismark_bt2_pe.bismark.cov,cases,chr17,41277160,41277160,0.528750826173166,8,1505,1513
SRR25023304_1_val_1_bismark_bt2_pe.bismark.cov,cases,chr17,41277174,41277174,0.593276203032301,9,1508,1517
SRR25023304_1_val_1_bismark_bt2_pe.bismark.cov,cases,chr17,41277214,41277214,0.655307994757536,10,1516,1526
SRR25023304_1_val_1_bismark_bt2_pe.bismark.cov,cases,chr17,41277232,41277232,1.18032786885246,18,1507,1525
SRR25023304_1_val_1_bismark_bt2_pe.bismark.cov,cases,chr17,56769746,56769746,96.2406015037594,128,5,133
SRR25023304_1_val_1_bismark_bt2_pe.bismark.cov,cases,chr17,56769760,56769760,92.5373134328358,124,10,134
SRR25023304_1_val_1_bismark_bt2_pe.bismark.cov,cases,chr17,56769767,56769767,82.8358208955224,111,23,134
SRR25023304_1_val_1_bismark_bt2_pe.bismark.cov,cases,chr17,56769830,56769830,3.64963503649635,5,132,137
SRR25023304_1_val_1_bismark_bt2_pe.bismark.cov,cases,chr17,56769866,56769866,0.0,0,138,138
SRR25023304_1_val_1_bismark_bt2_pe.bismark.cov,cases,chr17,56769883,56769883,0.72992700729927,1,136,137
SRR25023304_1_val_1_bismark_bt2_pe.bismark.cov,cases,chr17,56769891,56769891,0.0,0,136,136
SRR25023304_1_val_1_bismark_bt2_pe.bismark.cov,cases,chr17,56769895,56769895,2.94117647058824,4,132,136
SRR25023304_1_val_1_bismark_bt2_pe.bismark.cov,cases,chr17,56769904,56769904,0.735294117647059,1,135,136
SRR25023304_1_val_1_bismark_bt2_pe.bismark.cov,cases,chr17,56769912,56769912,0.0,0,135,135
SRR25023304_1_val_1_bismark_bt2_pe.bismark.cov,cases,chr17,56769922,56769922,0.0,0,133,133
SRR25023304_1_val_1_bismark_bt2_pe.bismark.cov,cases,chr17,56769929,56769929,3.00751879699248,4,129,133
SRR25023304_1_val_1_bismark_bt2_pe.bismark.cov,cases,chr17,56769936,56769936,0.0,0,134,134
SRR25023304_1_val_1_bismark_bt2_pe.bismark.cov,cases,chr17,56769941,56769941,0.0,0,134,134
SRR25023304_1_val_1_bismark_bt2_pe.bismark.cov,cases,chr17,56769944,56769944,5.26315789473684,7,126,133
SRR25023304_1_val_1_bismark_bt2_pe.bismark.cov,cases,chr17,56769948,56769948,0.0,0,133,133
SRR25023304_1_val_1_bismark_bt2_pe.bismark.cov,cases,chr17,56769956,56769956,1.61290322580645,2,122,124
SRR25023304_1_val_1_bismark_bt2_pe.bismark.cov,cases,chr17,56769962,56769962,0.909090909090909,1,109,110
SRR25023304_1_val_1_bismark_bt2_pe.bismark.cov,cases,chr17,56769966,56769966,0.0,0,112,112
SRR25023304_1_val_1_bismark_bt2_pe.bismark.cov,cases,chr17,56769982,56769982,0.0,0,114,114
SRR25023304_1_val_1_bismark_bt2_pe.bismark.cov,cases,chr17,56770003,56770003,3.30578512396694,4,117,121
SRR25023304_1_val_1_bismark_bt2_pe.bismark.cov,cases,chr17,56770008,56770008,0.0,0,119,119
SRR25023304_1_val_1_bismark_bt2_pe.bismark.cov,cases,chr17,56770010,56770010,0.0,0,120,120
SRR25023304_1_val_1_bismark_bt2_pe.bismark.cov,cases,chr17,56770018,56770018,0.0,0,123,123
SRR25023304_1_val_1_bismark_bt2_pe.bismark.cov,cases,chr17,56770023,56770023,5.64516129032258,7,117,124
SRR25023304_1_val_1_bismark_bt2_pe.bismark.cov,cases,chr17,56770038,56770038,0.0,0,124,124
SRR25023304_1_val_1_bismark_bt2_pe.bismark.cov,cases,chr17,56770057,56770057,0.793650793650794,1,125,126
SRR25023304_1_val_1_bismark_bt2_pe.bismark.cov,cases,chr17,56770069,56770069,0.0,0,127,127
SRR25023304_1_val_1_bismark_bt2_pe.bismark.cov,cases,chr17,56770074,56770074,0.0,0,128,128
SRR25023304_1_val_1_bismark_bt2_pe.bismark.cov,cases,chr17,56770093,56770093,0.0,0,128,128
SRR25023304_1_val_1_bismark_bt2_pe.bismark.cov,cases,chr17,59940970,59940970,1.88679245283019,3,156,159
SRR25023304_1_val_1_bismark_bt2_pe.bismark.cov,cases,chr17,59940975,59940975,0.0,0,159,159
SRR25023304_1_val_1_bismark_bt2_pe.bismark.cov,cases,chr17,59940988,59940988,1.25786163522013,2,157,159
SRR25023304_1_val_1_bismark_bt2_pe.bismark.cov,cases,chr17,59940997,59940997,0.0,0,155,155
SRR25023304_1_val_1_bismark_bt2_pe.bismark.cov,cases,chr17,59941017,59941017,1.08695652173913,1,91,92
SRR25023304_1_val_1_bismark_bt2_pe.bismark.cov,cases,chr17,59941051,59941051,0.0,0,161,161
SRR25023304_1_val_1_bismark_bt2_pe.bismark.cov,cases,chr17,59941053,59941053,0.0,0,175,175
SRR25023304_1_val_1_bismark_bt2_pe.bismark.cov,cases,chr17,59941056,59941056,1.24223602484472,2,159,161
SRR25023304_1_val_1_bismark_bt2_pe.bismark.cov,cases,chr17,59941067,59941067,1.78571428571429,3,165,168
SRR25023304_1_val_1_bismark_bt2_pe.bismark.cov,cases,chr17,59941110,59941110,0.0,0,183,183
SRR25023304_1_val_1_bismark_bt2_pe.bismark.cov,cases,chr17,59941133,59941133,0.0,0,183,183
SRR25023304_1_val_1_bismark_bt2_pe.bismark.cov,cases,chr17,59941136,59941136,0.546448087431694,1,182,183
SRR25023304_1_val_1_bismark_bt2_pe.bismark.cov,cases,chr17,59941187,59941187,0.0,0,183,183
SRR25023304_1_val_1_bismark_bt2_pe.bismark.cov,cases,chr17,59941191,59941191,1.09289617486339,2,181,183
SRR25023304_1_val_1_bismark_bt2_pe.bismark.cov,cases,chr17,59941201,59941201,1.41843971631206,2,139,141
SRR25023304_1_val_1_bismark_bt2_pe.bismark.cov,cases,chr17,59941202,59941202,2.77777777777778,1,35,36
SRR25023304_1_val_1_bismark_bt2_pe.bismark.cov,cases,chr17,76325846,76325846,33.8235294117647,23,45,68
SRR25023304_1_val_1_bismark_bt2_pe.bismark.cov,cases,chr17,76325851,76325851,13.2352941176471,9,59,68
SRR25023304_1_val_1_bismark_bt2_pe.bismark.cov,cases,chr17,76325865,76325865,11.7647058823529,8,60,68
SRR25023304_1_val_1_bismark_bt2_pe.bismark.cov,cases,chr17,76325979,76325979,60.0,42,28,70
SRR25023304_1_val_1_bismark_bt2_pe.bismark.cov,cases,chr14,45604787,45604787,0.0,0,280,280
SRR25023304_1_val_1_bismark_bt2_pe.bismark.cov,cases,chr14,45604794,45604794,0.357142857142857,1,279,280
SRR25023304_1_val_1_bismark_bt2_pe.bismark.cov,cases,chr6,43543548,43543548,1.72413793103448,2,114,116
SRR25023304_1_val_1_bismark_bt2_pe.bismark.cov,cases,chr6,43543554,43543554,2.60869565217391,3,112,115
SRR25023304_1_val_1_bismark_bt2_pe.bismark.cov,cases,chr6,43543571,43543571,0.0,0,115,115
SRR25023304_1_val_1_bismark_bt2_pe.bismark.cov,cases,chr6,43543578,43543578,0.862068965517241,1,115,116
SRR25023304_1_val_1_bismark_bt2_pe.bismark.cov,cases,chr6,43543580,43543580,0.0,0,116,116
SRR25023304_1_val_1_bismark_bt2_pe.bismark.cov,cases,chr6,43543596,43543596,0.0,0,116,116
SRR25023304_1_val_1_bismark_bt2_pe.bismark.cov,cases,chr6,43543608,43543608,0.0,0,117,117
SRR25023304_1_val_1_bismark_bt2_pe.bismark.cov,cases,chr6,43543613,43543613,1.70940170940171,2,115,117
SRR25023304_1_val_1_bismark_bt2_pe.bismark.cov,cases,chr6,43543615,43543615,0.854700854700855,1,116,117
SRR25023304_1_val_1_bismark_bt2_pe.bismark.cov,cases,chr6,43543618,43543618,0.0,0,117,117
SRR25023304_1_val_1_bismark_bt2_pe.bismark.cov,cases,chr6,43543624,43543624,0.0,0,116,116
SRR25023304_1_val_1_bismark_bt2_pe.bismark.cov,cases,chr6,43543642,43543642,0.0,0,117,117
SRR25023304_1_val_1_bismark_bt2_pe.bismark.cov,cases,chr6,43543650,43543650,0.0,0,118,118
SRR25023304_1_val_1_bismark_bt2_pe.bismark.cov,cases,chr6,43543657,43543657,0.0,0,118,118
SRR25023304_1_val_1_bismark_bt2_pe.bismark.cov,cases,chr6,43543669,43543669,1.69491525423729,2,116,118
SRR25023304_1_val_1_bismark_bt2_pe.bismark.cov,cases,chr6,43543672,43543672,0.0,0,118,118
SRR25023304_1_val_1_bismark_bt2_pe.bismark.cov,cases,chr6,43543682,43543682,0.0,0,118,118
SRR25023304_1_val_1_bismark_bt2_pe.bismark.cov,cases,chr6,43543691,43543691,0.854700854700855,1,116,117
SRR25023304_1_val_1_bismark_bt2_pe.bismark.cov,cases,chr6,43543696,43543696,6.83760683760684,8,109,117
SRR25023304_1_val_1_bismark_bt2_pe.bismark.cov,cases,chr6,43543698,43543698,0.0,0,117,117
SRR25023304_1_val_1_bismark_bt2_pe.bismark.cov,cases,chr6,43543701,43543701,1.70940170940171,2,115,117
SRR25023304_1_val_1_bismark_bt2_pe.bismark.cov,cases,chr6,43543705,43543705,1.70940170940171,2,115,117
SRR25023304_1_val_1_bismark_bt2_pe.bismark.cov,cases,chr6,43543708,43543708,0.0,0,116,116
SRR25023304_1_val_1_bismark_bt2_pe.bismark.cov,cases,chr6,43543733,43543733,0.0,0,118,118
SRR25023304_1_val_1_bismark_bt2_pe.bismark.cov,cases,chr6,43543747,43543747,0.847457627118644,1,117,118
SRR25023304_1_val_1_bismark_bt2_pe.bismark.cov,cases,chr6,43543749,43543749,0.840336134453782,1,118,119
SRR25023304_1_val_1_bismark_bt2_pe.bismark.cov,cases,chr6,43543763,43543763,0.0,0,117,117
SRR25023304_1_val_1_bismark_bt2_pe.bismark.cov,cases,chr6,43543766,43543766,0.0,0,117,117
SRR25023304_1_val_1_bismark_bt2_pe.bismark.cov,cases,chr6,43543771,43543771,0.869565217391304,1,114,115
SRR25023304_1_val_1_bismark_bt2_pe.bismark.cov,cases,chr6,43543775,43543775,1.76991150442478,2,111,113
SRR25023304_1_val_1_bismark_bt2_pe.bismark.cov,cases,chr6,43543777,43543777,0.892857142857143,1,111,112
SRR25023304_1_val_1_bismark_bt2_pe.bismark.cov,cases,chr6,43543781,43543781,0.0,0,112,112
SRR25023304_1_val_1_bismark_bt2_pe.bismark.cov,cases,chr6,43543786,43543786,0.884955752212389,1,112,113
SRR25023304_1_val_1_bismark_bt2_pe.bismark.cov,cases,chr6,43543794,43543794,0.0,0,114,114
SRR25023304_1_val_1_bismark_bt2_pe.bismark.cov,cases,chr6,43543798,43543798,0.0,0,115,115
SRR25023304_1_val_1_bismark_bt2_pe.bismark.cov,cases,chr6,43543800,43543800,0.869565217391304,1,114,115
SRR25023304_1_val_1_bismark_bt2_pe.bismark.cov,cases,chr6,43543804,43543804,0.0,0,115,115
SRR25023304_1_val_1_bismark_bt2_pe.bismark.cov,cases,chr6,43543806,43543806,2.58620689655172,3,113,116
SRR25023304_1_val_1_bismark_bt2_pe.bismark.cov,cases,chr6,43543815,43543815,1.68067226890756,2,117,119
SRR25023304_1_val_1_bismark_bt2_pe.bismark.cov,cases,chr6,43543822,43543822,0.847457627118644,1,117,118
SRR25023304_1_val_1_bismark_bt2_pe.bismark.cov,cases,chr6,166980423,166980423,0.0,0,40,40
SRR25023304_1_val_1_bismark_bt2_pe.bismark.cov,cases,chr6,166980458,166980458,97.6190476190476,41,1,42
SRR25023304_1_val_1_bismark_bt2_pe.bismark.cov,cases,chr6,166980461,166980461,97.6190476190476,41,1,42
SRR25023304_1_val_1_bismark_bt2_pe.bismark.cov,cases,chr6,166980514,166980514,97.7272727272727,43,1,44
SRR25023304_1_val_1_bismark_bt2_pe.bismark.cov,cases,chr6,166980619,166980619,97.8260869565217,45,1,46
SRR25023304_1_val_1_bismark_bt2_pe.bismark.cov,cases,chr6,166980630,166980630,97.8260869565217,45,1,46
SRR25023304_1_val_1_bismark_bt2_pe.bismark.cov,cases,chrX,14891454,14891454,21.4146023468057,657,2411,3068
SRR25023304_1_val_1_bismark_bt2_pe.bismark.cov,cases,chrX,14891470,14891470,15.2315720808871,467,2599,3066
SRR25023304_1_val_1_bismark_bt2_pe.bismark.cov,cases,chrX,14891474,14891474,35.6631989596879,1097,1979,3076
SRR25023304_1_val_1_bismark_bt2_pe.bismark.cov,cases,chrX,14891488,14891488,24.8942401561992,765,2308,3073
SRR25023304_1_val_1_bismark_bt2_pe.bismark.cov,cases,chrX,14891493,14891493,43.6031331592689,1336,1728,3064
SRR25023304_1_val_1_bismark_bt2_pe.bismark.cov,cases,chrX,14891496,14891496,29.3658536585366,903,2172,3075
SRR25023304_1_val_1_bismark_bt2_pe.bismark.cov,cases,chrX,14891499,14891499,21.19140625,651,2421,3072
SRR25023304_1_val_1_bismark_bt2_pe.bismark.cov,cases,chrX,14891509,14891509,41.7371502927781,1283,1791,3074
SRR25023304_1_val_1_bismark_bt2_pe.bismark.cov,cases,chrX,14891516,14891516,44.8826597131682,1377,1691,3068
SRR25023304_1_val_1_bismark_bt2_pe.bismark.cov,cases,chrX,14891524,14891524,23.9413680781759,735,2335,3070
SRR25023304_1_val_1_bismark_bt2_pe.bismark.cov,cases,chrX,14891526,14891526,30.7014681892333,941,2124,3065
SRR25023304_1_val_1_bismark_bt2_pe.bismark.cov,cases,chrX,14891530,14891530,40.1238591916558,1231,1837,3068
SRR25023304_1_val_1_bismark_bt2_pe.bismark.cov,cases,chr7,6048869,6048869,0.464653169598407,14,2999,3013
SRR25023304_1_val_1_bismark_bt2_pe.bismark.cov,cases,chr7,6048876,6048876,0.298606502986065,9,3005,3014
SRR25023304_1_val_1_bismark_bt2_pe.bismark.cov,cases,chr7,6048884,6048884,0.166057788110262,5,3006,3011
SRR25023304_1_val_1_bismark_bt2_pe.bismark.cov,cases,chr7,6048888,6048888,0.266400266400266,8,2995,3003
SRR25023304_1_val_1_bismark_bt2_pe.bismark.cov,cases,chr7,6048892,6048892,0.331895121141719,10,3003,3013
SRR25023304_1_val_1_bismark_bt2_pe.bismark.cov,cases,chr7,6048904,6048904,0.0,0,646,646
SRR25023304_1_val_1_bismark_bt2_pe.bismark.cov,cases,chr7,6048918,6048918,0.165672630881378,5,3013,3018
SRR25023304_1_val_1_bismark_bt2_pe.bismark.cov,cases,chr7,6048925,6048925,0.464344941956882,14,3001,3015
SRR25023304_1_val_1_bismark_bt2_pe.bismark.cov,cases,chr7,6048928,6048928,0.596026490066225,18,3002,3020
SRR25023304_1_val_1_bismark_bt2_pe.bismark.cov,cases,chr7,6048940,6048940,0.529450694904037,16,3006,3022
SRR25023304_1_val_1_bismark_bt2_pe.bismark.cov,cases,chr7,6048951,6048951,0.363756613756614,11,3013,3024
SRR25023304_1_val_1_bismark_bt2_pe.bismark.cov,cases,chr7,6048966,6048966,0.694214876033058,21,3004,3025
SRR25023304_1_val_1_bismark_bt2_pe.bismark.cov,cases,chr7,6048968,6048968,0.464961806708735,14,2997,3011
SRR25023304_1_val_1_bismark_bt2_pe.bismark.cov,cases,chr16,23652769,23652769,0.606060606060606,3,492,495
SRR25023304_1_val_1_bismark_bt2_pe.bismark.cov,cases,chr16,23652783,23652783,0.804828973843058,4,493,497
SRR25023304_1_val_1_bismark_bt2_pe.bismark.cov,cases,chr16,23652787,23652787,0.803212851405622,4,494,498
SRR25023304_1_val_1_bismark_bt2_pe.bismark.cov,cases,chr16,23652797,23652797,0.404040404040404,2,493,495
SRR25023304_1_val_1_bismark_bt2_pe.bismark.cov,cases,chr16,23652818,23652818,0.404858299595142,2,492,494
SRR25023304_1_val_1_bismark_bt2_pe.bismark.cov,cases,chr16,23652838,23652838,1.01214574898785,5,489,494
SRR25023304_1_val_1_bismark_bt2_pe.bismark.cov,cases,chr16,23652857,23652857,0.399201596806387,2,499,501
SRR25023304_1_val_1_bismark_bt2_pe.bismark.cov,cases,chr16,23652860,23652860,0.6,3,497,500
SRR25023304_1_val_1_bismark_bt2_pe.bismark.cov,cases,chr16,23652876,23652876,0.6,3,497,500
SRR25023304_1_val_1_bismark_bt2_pe.bismark.cov,cases,chr16,23652906,23652906,0.4,2,498,500
SRR25023304_1_val_1_bismark_bt2_pe.bismark.cov,cases,chr16,23652911,23652911,1.40280561122244,7,492,499
SRR25023304_1_val_1_bismark_bt2_pe.bismark.cov,cases,chr16,23652916,23652916,0.824742268041237,4,481,485
SRR25023304_1_val_1_bismark_bt2_pe.bismark.cov,cases,chr16,23652918,23652918,0.0,0,498,498
SRR25023305_1_val_1_bismark_bt2_pe.bismark.cov,cases,chr13,32889392,32889392,18.7461773700306,613,2657,3270
SRR25023305_1_val_1_bismark_bt2_pe.bismark.cov,cases,chr13,32889434,32889434,2.81776416539051,92,3173,3265
SRR25023305_1_val_1_bismark_bt2_pe.bismark.cov,cases,chr13,32889461,32889461,0.706605222734255,23,3232,3255
SRR25023305_1_val_1_bismark_bt2_pe.bismark.cov,cases,chr13,32889470,32889470,0.368211107701749,12,3247,3259
SRR25023305_1_val_1_bismark_bt2_pe.bismark.cov,cases,chr13,32889484,32889484,0.55367579206398,18,3233,3251
SRR25023305_1_val_1_bismark_bt2_pe.bismark.cov,cases,chr13,108867034,108867034,38.4463462804477,584,935,1519
SRR25023305_1_val_1_bismark_bt2_pe.bismark.cov,cases,chr13,108867035,108867035,2.94117647058824,1,33,34
SRR25023305_1_val_1_bismark_bt2_pe.bismark.cov,cases,chr13,108867044,108867044,46.1093247588424,717,838,1555
SRR25023305_1_val_1_bismark_bt2_pe.bismark.cov,cases,chr13,108867051,108867051,45.6185567010309,708,844,1552
SRR25023305_1_val_1_bismark_bt2_pe.bismark.cov,cases,chr13,108867109,108867109,73.19257837492,1144,419,1563
SRR25023305_1_val_1_bismark_bt2_pe.bismark.cov,cases,chr13,108867112,108867112,81.9693094629156,1282,282,1564
SRR25023305_1_val_1_bismark_bt2_pe.bismark.cov,cases,chr13,108867124,108867124,63.3802816901408,990,572,1562
SRR25023305_1_val_1_bismark_bt2_pe.bismark.cov,cases,chr13,108867135,108867135,55.6125721616421,867,692,1559
SRR25023305_1_val_1_bismark_bt2_pe.bismark.cov,cases,chr13,108867155,108867155,50.096215522771,781,778,1559
SRR25023305_1_val_1_bismark_bt2_pe.bismark.cov,cases,chr2,47596828,47596828,3.06065664997218,55,1742,1797
SRR25023305_1_val_1_bismark_bt2_pe.bismark.cov,cases,chr2,47596830,47596830,3.6204059243006,66,1757,1823
SRR25023305_1_val_1_bismark_bt2_pe.bismark.cov,cases,chr2,47596840,47596840,3.62239297475302,66,1756,1822
SRR25023305_1_val_1_bismark_bt2_pe.bismark.cov,cases,chr2,47596849,47596849,16.9686985172982,309,1512,1821
SRR25023305_1_val_1_bismark_bt2_pe.bismark.cov,cases,chr2,47596853,47596853,5.43060888645091,99,1724,1823
SRR25023305_1_val_1_bismark_bt2_pe.bismark.cov,cases,chr2,47596858,47596858,10.3675260559517,189,1634,1823
SRR25023305_1_val_1_bismark_bt2_pe.bismark.cov,cases,chr2,47596862,47596862,9.44017563117453,172,1650,1822
SRR25023305_1_val_1_bismark_bt2_pe.bismark.cov,cases,chr2,47596869,47596869,21.1074561403509,385,1439,1824
SRR25023305_1_val_1_bismark_bt2_pe.bismark.cov,cases,chr2,47596883,47596883,13.5938359933957,247,1570,1817
SRR25023305_1_val_1_bismark_bt2_pe.bismark.cov,cases,chr2,47596885,47596885,3.91184573002755,71,1744,1815
SRR25023305_1_val_1_bismark_bt2_pe.bismark.cov,cases,chr2,47596887,47596887,7.26872246696035,132,1684,1816
SRR25023305_1_val_1_bismark_bt2_pe.bismark.cov,cases,chr2,47596897,47596897,5.38461538461539,98,1722,1820
SRR25023305_1_val_1_bismark_bt2_pe.bismark.cov,cases,chr2,47596900,47596900,3.90969162995595,71,1745,1816
SRR25023305_1_val_1_bismark_bt2_pe.bismark.cov,cases,chr2,47596907,47596907,4.07488986784141,74,1742,1816
SRR25023305_1_val_1_bismark_bt2_pe.bismark.cov,cases,chr2,47596912,47596912,3.35903083700441,61,1755,1816
SRR25023305_1_val_1_bismark_bt2_pe.bismark.cov,cases,chr2,47596930,47596930,5.69690265486726,103,1705,1808
SRR25023305_1_val_1_bismark_bt2_pe.bismark.cov,cases,chr2,47596942,47596942,6.72546857772878,122,1692,1814
SRR25023305_1_val_1_bismark_bt2_pe.bismark.cov,cases,chr2,47630224,47630224,0.922045264040235,11,1182,1193
SRR25023305_1_val_1_bismark_bt2_pe.bismark.cov,cases,chr2,47630227,47630227,0.658978583196046,8,1206,1214
SRR25023305_1_val_1_bismark_bt2_pe.bismark.cov,cases,chr2,47630233,47630233,0.740740740740741,9,1206,1215
SRR25023305_1_val_1_bismark_bt2_pe.bismark.cov,cases,chr2,47630237,47630237,0.494233937397035,6,1208,1214
SRR25023305_1_val_1_bismark_bt2_pe.bismark.cov,cases,chr2,47630240,47630240,1.97693574958814,24,1190,1214
SRR25023305_1_val_1_bismark_bt2_pe.bismark.cov,cases,chr2,47630244,47630244,1.15702479338843,14,1196,1210
SRR25023305_1_val_1_bismark_bt2_pe.bismark.cov,cases,chr2,47630251,47630251,0.577081615828524,7,1206,1213
SRR25023305_1_val_1_bismark_bt2_pe.bismark.cov,cases,chr2,47630265,47630265,0.658978583196046,8,1206,1214
SRR25023305_1_val_1_bismark_bt2_pe.bismark.cov,cases,chr2,47630292,47630292,0.496277915632754,6,1203,1209
SRR25023305_1_val_1_bismark_bt2_pe.bismark.cov,cases,chr2,47630294,47630294,0.412201154163232,5,1208,1213
SRR25023305_1_val_1_bismark_bt2_pe.bismark.cov,cases,chr2,128051674,128051674,0.0,0,225,225
SRR25023305_1_val_1_bismark_bt2_pe.bismark.cov,cases,chr2,128051690,128051690,0.31813361611877,3,940,943
SRR25023305_1_val_1_bismark_bt2_pe.bismark.cov,cases,chr2,128051704,128051704,0.531914893617021,5,935,940
SRR25023305_1_val_1_bismark_bt2_pe.bismark.cov,cases,chr2,128051707,128051707,0.31813361611877,3,940,943
SRR25023305_1_val_1_bismark_bt2_pe.bismark.cov,cases,chr2,128051709,128051709,1.48777895855473,14,927,941
SRR25023305_1_val_1_bismark_bt2_pe.bismark.cov,cases,chr2,128051716,128051716,0.106382978723404,1,939,940
SRR25023305_1_val_1_bismark_bt2_pe.bismark.cov,cases,chr2,128051733,128051733,0.423728813559322,4,940,944
SRR25023305_1_val_1_bismark_bt2_pe.bismark.cov,cases,chr2,128051743,128051743,1.58898305084746,15,929,944
SRR25023305_1_val_1_bismark_bt2_pe.bismark.cov,cases,chr2,178787742,178787742,91.9614147909968,286,25,311
SRR25023305_1_val_1_bismark_bt2_pe.bismark.cov,cases,chr2,241151145,241151145,100.0,23,0,23
SRR25023305_1_val_1_bismark_bt2_pe.bismark.cov,cases,chr2,241151165,241151165,96.0,24,1,25
SRR25023305_1_val_1_bismark_bt2_pe.bismark.cov,cases,chr2,241151205,241151205,96.1538461538462,25,1,26
SRR25023305_1_val_1_bismark_bt2_pe.bismark.cov,cases,chr2,241151217,241151217,96.1538461538462,25,1,26
SRR25023305_1_val_1_bismark_bt2_pe.bismark.cov,cases,chr2,241151277,241151277,0.0,0,22,22
SRR25023305_1_val_1_bismark_bt2_pe.bismark.cov,cases,chr3,37034307,37034307,99.8690671031097,3051,4,3055
SRR25023305_1_val_1_bismark_bt2_pe.bismark.cov,cases,chr3,37034316,37034316,0.523388943408571,16,3041,3057
SRR25023305_1_val_1_bismark_bt2_pe.bismark.cov,cases,chr3,37034324,37034324,0.65402223675605,20,3038,3058
SRR25023305_1_val_1_bismark_bt2_pe.bismark.cov,cases,chr3,37034330,37034330,0.327118089630357,10,3047,3057
SRR25023305_1_val_1_bismark_bt2_pe.bismark.cov,cases,chr3,37034344,37034344,1.07984293193717,33,3023,3056
SRR25023305_1_val_1_bismark_bt2_pe.bismark.cov,cases,chr3,37034346,37034346,0.425392670157068,13,3043,3056
SRR25023305_1_val_1_bismark_bt2_pe.bismark.cov,cases,chr3,37034348,37034348,0.653381247958184,20,3041,3061
SRR25023305_1_val_1_bismark_bt2_pe.bismark.cov,cases,chr3,37034352,37034352,0.84911822338341,26,3036,3062
SRR25023305_1_val_1_bismark_bt2_pe.bismark.cov,cases,chr3,37034355,37034355,0.751633986928105,23,3037,3060
SRR25023305_1_val_1_bismark_bt2_pe.bismark.cov,cases,chr3,37034359,37034359,0.718015665796345,22,3042,3064
SRR25023305_1_val_1_bismark_bt2_pe.bismark.cov,cases,chr3,37034369,37034369,0.903312144529943,27,2962,2989
SRR25023305_1_val_1_bismark_bt2_pe.bismark.cov,cases,chr3,37034373,37034373,0.848010437051533,26,3040,3066
SRR25023305_1_val_1_bismark_bt2_pe.bismark.cov,cases,chr3,37034382,37034382,0.751143043762247,23,3039,3062
SRR25023305_1_val_1_bismark_bt2_pe.bismark.cov,cases,chr3,37034394,37034394,0.261437908496732,8,3052,3060
SRR25023305_1_val_1_bismark_bt2_pe.bismark.cov,cases,chr3,37034402,37034402,0.392670157068063,12,3044,3056
SRR25023305_1_val_1_bismark_bt2_pe.bismark.cov,cases,chr3,37034409,37034409,0.29382957884427,9,3054,3063
SRR25023305_1_val_1_bismark_bt2_pe.bismark.cov,cases,chr3,37034412,37034412,1.04540999673309,32,3029,3061
SRR25023305_1_val_1_bismark_bt2_pe.bismark.cov,cases,chr3,37034414,37034414,1.01340307289964,31,3028,3059
SRR25023305_1_val_1_bismark_bt2_pe.bismark.cov,cases,chr3,37034418,37034418,0.816726559947729,25,3036,3061
SRR25023305_1_val_1_bismark_bt2_pe.bismark.cov,cases,chr3,37034420,37034420,0.457516339869281,14,3046,3060
SRR25023305_1_val_1_bismark_bt2_pe.bismark.cov,cases,chr3,37034430,37034430,0.654236179260713,20,3037,3057
SRR25023305_1_val_1_bismark_bt2_pe.bismark.cov,cases,chr3,37034438,37034438,0.818866688503112,25,3028,3053
SRR25023305_1_val_1_bismark_bt2_pe.bismark.cov,cases,chr3,37034441,37034441,0.850228907782865,26,3032,3058
SRR25023305_1_val_1_bismark_bt2_pe.bismark.cov,cases,chr3,37034466,37034466,99.9013157894737,3037,3,3040
SRR25023305_1_val_1_bismark_bt2_pe.bismark.cov,cases,chr3,37034997,37034997,0.34965034965035,15,4275,4290
SRR25023305_1_val_1_bismark_bt2_pe.bismark.cov,cases,chr3,37035012,37035012,0.256410256410256,11,4279,4290
SRR25023305_1_val_1_bismark_bt2_pe.bismark.cov,cases,chr3,37035032,37035032,0.372873456070846,16,4275,4291
SRR25023305_1_val_1_bismark_bt2_pe.bismark.cov,cases,chr3,37035043,37035043,0.535381750465549,23,4273,4296
SRR25023305_1_val_1_bismark_bt2_pe.bismark.cov,cases,chr3,37035047,37035047,0.628053035589672,27,4272,4299
SRR25023305_1_val_1_bismark_bt2_pe.bismark.cov,cases,chr3,37035063,37035063,0.442477876106195,19,4275,4294
SRR25023305_1_val_1_bismark_bt2_pe.bismark.cov,cases,chr3,37035066,37035066,0.418702023726448,18,4281,4299
SRR25023305_1_val_1_bismark_bt2_pe.bismark.cov,cases,chr3,37035074,37035074,0.744359153291463,32,4267,4299
SRR25023305_1_val_1_bismark_bt2_pe.bismark.cov,cases,chr3,37035090,37035090,0.791065611912518,34,4264,4298
SRR25023305_1_val_1_bismark_bt2_pe.bismark.cov,cases,chr3,37035095,37035095,0.604510578935131,26,4275,4301
SRR25023305_1_val_1_bismark_bt2_pe.bismark.cov,cases,chr3,37035097,37035097,0.697836706210747,30,4269,4299
SRR25023305_1_val_1_bismark_bt2_pe.bismark.cov,cases,chr3,37035100,37035100,0.395993477754484,17,4276,4293
SRR25023305_1_val_1_bismark_bt2_pe.bismark.cov,cases,chr3,37035117,37035117,0.557880055788006,24,4278,4302
SRR25023305_1_val_1_bismark_bt2_pe.bismark.cov,cases,chr3,142297977,142297977,0.331858407079646,3,901,904
SRR25023305_1_val_1_bismark_bt2_pe.bismark.cov,cases,chr3,142298019,142298019,0.662983425414365,6,899,905
SRR25023305_1_val_1_bismark_bt2_pe.bismark.cov,cases,chr3,142298045,142298045,0.884955752212389,8,896,904
SRR25023305_1_val_1_bismark_bt2_pe.bismark.cov,cases,chr3,142298054,142298054,3.5437430786268,32,871,903
SRR25023305_1_val_1_bismark_bt2_pe.bismark.cov,cases,chr10,89619506,89619506,97.9274611398964,1134,24,1158
SRR25023305_1_val_1_bismark_bt2_pe.bismark.cov,cases,chr10,89619510,89619510,97.7624784853701,1136,26,1162
SRR25023305_1_val_1_bismark_bt2_pe.bismark.cov,cases,chr10,89619512,89619512,98.7962166809974,1149,14,1163
SRR25023305_1_val_1_bismark_bt2_pe.bismark.cov,cases,chr10,89619522,89619522,98.5395189003437,1147,17,1164
SRR25023305_1_val_1_bismark_bt2_pe.bismark.cov,cases,chr10,89619550,89619550,97.934595524957,1138,24,1162
SRR25023305_1_val_1_bismark_bt2_pe.bismark.cov,cases,chr10,89619555,89619555,98.1067125645439,1140,22,1162
SRR25023305_1_val_1_bismark_bt2_pe.bismark.cov,cases,chr10,89619566,89619566,93.5177182368194,1082,75,1157
SRR25023305_1_val_1_bismark_bt2_pe.bismark.cov,cases,chr10,89619580,89619580,93.7984496124031,1089,72,1161
SRR25023305_1_val_1_bismark_bt2_pe.bismark.cov,cases,chr8,30890012,30890012,67.8456591639871,422,200,622
SRR25023305_1_val_1_bismark_bt2_pe.bismark.cov,cases,chr8,30890034,30890034,73.7785016286645,453,161,614
SRR25023305_1_val_1_bismark_bt2_pe.bismark.cov,cases,chr8,30890051,30890051,94.9013157894737,577,31,608
SRR25023305_1_val_1_bismark_bt2_pe.bismark.cov,cases,chr8,30890057,30890057,80.1313628899836,488,121,609
SRR25023305_1_val_1_bismark_bt2_pe.bismark.cov,cases,chr8,30890073,30890073,56.3011456628478,344,267,611
SRR25023305_1_val_1_bismark_bt2_pe.bismark.cov,cases,chr8,30890108,30890108,14.6381578947368,89,519,608
SRR25023305_1_val_1_bismark_bt2_pe.bismark.cov,cases,chr8,30890133,30890133,28.33607907743,172,435,607
SRR25023305_1_val_1_bismark_bt2_pe.bismark.cov,cases,chr8,30890139,30890139,51.4802631578947,313,295,608
SRR25023305_1_val_1_bismark_bt2_pe.bismark.cov,cases,chr8,30890145,30890145,13.673805601318,83,524,607
SRR25023305_1_val_1_bismark_bt2_pe.bismark.cov,cases,chr8,30890170,30890170,20.2321724709784,122,481,603
SRR25023305_1_val_1_bismark_bt2_pe.bismark.cov,cases,chr8,30890172,30890172,17.6859504132231,107,498,605
SRR25023305_1_val_1_bismark_bt2_pe.bismark.cov,cases,chr8,90997245,90997245,28.4210526315789,27,68,95
SRR25023305_1_val_1_bismark_bt2_pe.bismark.cov,cases,chr8,90997299,90997299,2.22222222222222,2,88,90
SRR25023305_1_val_1_bismark_bt2_pe.bismark.cov,cases,chr8,90997454,90997454,26.9230769230769,21,57,78
SRR25023305_1_val_1_bismark_bt2_pe.bismark.cov,cases,chr8,90997482,90997482,96.2025316455696,76,3,79
SRR25023305_1_val_1_bismark_bt2_pe.bismark.cov,cases,chr6,43543548,43543548,0.72463768115942,1,137,138
SRR25023305_1_val_1_bismark_bt2_pe.bismark.cov,cases,chr6,43543554,43543554,2.18978102189781,3,134,137
SRR25023305_1_val_1_bismark_bt2_pe.bismark.cov,cases,chr6,43543571,43543571,0.719424460431655,1,138,139
SRR25023305_1_val_1_bismark_bt2_pe.bismark.cov,cases,chr6,43543578,43543578,0.0,0,139,139
SRR25023305_1_val_1_bismark_bt2_pe.bismark.cov,cases,chr6,43543580,43543580,1.43884892086331,2,137,139
SRR25023305_1_val_1_bismark_bt2_pe.bismark.cov,cases,chr6,43543596,43543596,0.719424460431655,1,138,139
SRR25023305_1_val_1_bismark_bt2_pe.bismark.cov,cases,chr6,43543608,43543608,0.0,0,139,139
SRR25023305_1_val_1_bismark_bt2_pe.bismark.cov,cases,chr6,43543613,43543613,1.43884892086331,2,137,139
SRR25023305_1_val_1_bismark_bt2_pe.bismark.cov,cases,chr6,43543615,43543615,0.0,0,139,139
SRR25023305_1_val_1_bismark_bt2_pe.bismark.cov,cases,chr6,43543618,43543618,0.0,0,139,139
SRR25023305_1_val_1_bismark_bt2_pe.bismark.cov,cases,chr6,43543624,43543624,0.72992700729927,1,136,137
SRR25023305_1_val_1_bismark_bt2_pe.bismark.cov,cases,chr6,43543642,43543642,0.72463768115942,1,137,138
SRR25023305_1_val_1_bismark_bt2_pe.bismark.cov,cases,chr6,43543650,43543650,0.719424460431655,1,138,139
SRR25023305_1_val_1_bismark_bt2_pe.bismark.cov,cases,chr6,43543657,43543657,0.72463768115942,1,137,138
SRR25023305_1_val_1_bismark_bt2_pe.bismark.cov,cases,chr6,43543669,43543669,0.735294117647059,1,135,136
SRR25023305_1_val_1_bismark_bt2_pe.bismark.cov,cases,chr6,43543672,43543672,0.0,0,136,136
SRR25023305_1_val_1_bismark_bt2_pe.bismark.cov,cases,chr6,43543682,43543682,0.72992700729927,1,136,137
SRR25023305_1_val_1_bismark_bt2_pe.bismark.cov,cases,chr6,43543691,43543691,0.0,0,137,137
SRR25023305_1_val_1_bismark_bt2_pe.bismark.cov,cases,chr6,43543696,43543696,7.35294117647059,10,126,136
SRR25023305_1_val_1_bismark_bt2_pe.bismark.cov,cases,chr6,43543698,43543698,0.740740740740741,1,134,135
SRR25023305_1_val_1_bismark_bt2_pe.bismark.cov,cases,chr6,43543701,43543701,3.73134328358209,5,129,134
SRR25023305_1_val_1_bismark_bt2_pe.bismark.cov,cases,chr6,43543705,43543705,0.0,0,135,135
SRR25023305_1_val_1_bismark_bt2_pe.bismark.cov,cases,chr6,43543708,43543708,0.740740740740741,1,134,135
SRR25023305_1_val_1_bismark_bt2_pe.bismark.cov,cases,chr6,43543733,43543733,0.0,0,129,129
SRR25023305_1_val_1_bismark_bt2_pe.bismark.cov,cases,chr6,43543747,43543747,0.78125,1,127,128
SRR25023305_1_val_1_bismark_bt2_pe.bismark.cov,cases,chr6,43543749,43543749,0.78740157480315,1,126,127
SRR25023305_1_val_1_bismark_bt2_pe.bismark.cov,cases,chr6,43543763,43543763,0.0,0,124,124
SRR25023305_1_val_1_bismark_bt2_pe.bismark.cov,cases,chr6,43543766,43543766,0.813008130081301,1,122,123
SRR25023305_1_val_1_bismark_bt2_pe.bismark.cov,cases,chr6,43543771,43543771,0.806451612903226,1,123,124
SRR25023305_1_val_1_bismark_bt2_pe.bismark.cov,cases,chr6,43543775,43543775,1.6,2,123,125
SRR25023305_1_val_1_bismark_bt2_pe.bismark.cov,cases,chr6,43543777,43543777,0.0,0,125,125
SRR25023305_1_val_1_bismark_bt2_pe.bismark.cov,cases,chr6,43543781,43543781,0.0,0,126,126
SRR25023305_1_val_1_bismark_bt2_pe.bismark.cov,cases,chr6,43543786,43543786,0.793650793650794,1,125,126
SRR25023305_1_val_1_bismark_bt2_pe.bismark.cov,cases,chr6,43543794,43543794,0.806451612903226,1,123,124
SRR25023305_1_val_1_bismark_bt2_pe.bismark.cov,cases,chr6,43543798,43543798,0.806451612903226,1,123,124
SRR25023305_1_val_1_bismark_bt2_pe.bismark.cov,cases,chr6,43543800,43543800,0.826446280991736,1,120,121
SRR25023305_1_val_1_bismark_bt2_pe.bismark.cov,cases,chr6,43543804,43543804,0.0,0,121,121
SRR25023305_1_val_1_bismark_bt2_pe.bismark.cov,cases,chr6,43543806,43543806,0.0,0,121,121
SRR25023305_1_val_1_bismark_bt2_pe.bismark.cov,cases,chr6,43543815,43543815,0.840336134453782,1,118,119
SRR25023305_1_val_1_bismark_bt2_pe.bismark.cov,cases,chr6,43543822,43543822,0.0,0,120,120
SRR25023305_1_val_1_bismark_bt2_pe.bismark.cov,cases,chr6,166980423,166980423,0.0,0,44,44
SRR25023305_1_val_1_bismark_bt2_pe.bismark.cov,cases,chr6,166980458,166980458,85.1063829787234,40,7,47
SRR25023305_1_val_1_bismark_bt2_pe.bismark.cov,cases,chr6,166980461,166980461,93.6170212765958,44,3,47
SRR25023305_1_val_1_bismark_bt2_pe.bismark.cov,cases,chr6,166980514,166980514,100.0,47,0,47
SRR25023305_1_val_1_bismark_bt2_pe.bismark.cov,cases,chr6,166980619,166980619,90.0,45,5,50
SRR25023305_1_val_1_bismark_bt2_pe.bismark.cov,cases,chr6,166980630,166980630,100.0,50,0,50
SRR25023305_1_val_1_bismark_bt2_pe.bismark.cov,cases,chr11,108093323,108093323,0.460829493087558,4,864,868
SRR25023305_1_val_1_bismark_bt2_pe.bismark.cov,cases,chr11,108093335,108093335,0.806451612903226,7,861,868
SRR25023305_1_val_1_bismark_bt2_pe.bismark.cov,cases,chr11,108093338,108093338,0.694444444444444,6,858,864
SRR25023305_1_val_1_bismark_bt2_pe.bismark.cov,cases,chr11,108093359,108093359,0.234192037470726,2,852,854
SRR25023305_1_val_1_bismark_bt2_pe.bismark.cov,cases,chr11,108093371,108093371,0.3125,2,638,640
SRR25023305_1_val_1_bismark_bt2_pe.bismark.cov,cases,chr11,108093373,108093373,0.0,0,640,640
SRR25023305_1_val_1_bismark_bt2_pe.bismark.cov,cases,chr11,108093386,108093386,0.470957613814757,3,634,637
SRR25023305_1_val_1_bismark_bt2_pe.bismark.cov,cases,chr11,108093395,108093395,0.9375,6,634,640
SRR25023305_1_val_1_bismark_bt2_pe.bismark.cov,cases,chr11,108093402,108093402,0.94488188976378,6,629,635
SRR25023305_1_val_1_bismark_bt2_pe.bismark.cov,cases,chr11,108093413,108093413,0.317965023847377,2,627,629
SRR25023305_1_val_1_bismark_bt2_pe.bismark.cov,cases,chr11,108093419,108093419,1.11287758346582,7,622,629
SRR25023305_1_val_1_bismark_bt2_pe.bismark.cov,cases,chr11,108093436,108093436,0.477707006369427,3,625,628
SRR25023305_1_val_1_bismark_bt2_pe.bismark.cov,cases,chr11,108093439,108093439,0.636942675159236,4,624,628
SRR25023305_1_val_1_bismark_bt2_pe.bismark.cov,cases,chr11,108093451,108093451,0.797448165869218,5,622,627
SRR25023305_1_val_1_bismark_bt2_pe.bismark.cov,cases,chr11,108093457,108093457,0.477707006369427,3,625,628
SRR25023305_1_val_1_bismark_bt2_pe.bismark.cov,cases,chr11,108093461,108093461,0.318979266347687,2,625,627
SRR25023305_1_val_1_bismark_bt2_pe.bismark.cov,cases,chr11,108093467,108093467,0.64,4,621,625
SRR25023305_1_val_1_bismark_bt2_pe.bismark.cov,cases,chr11,108093476,108093476,0.802568218298555,5,618,623
SRR25023305_1_val_1_bismark_bt2_pe.bismark.cov,cases,chr11,108093485,108093485,0.322061191626409,2,619,621
SRR25023305_1_val_1_bismark_bt2_pe.bismark.cov,cases,chr11,108093505,108093505,0.340715502555366,2,585,587
SRR25023305_1_val_1_bismark_bt2_pe.bismark.cov,cases,chr11,108093520,108093520,0.21551724137931,1,463,464
SRR25023305_1_val_1_bismark_bt2_pe.bismark.cov,cases,chr11,108093529,108093529,0.0,0,31,31
SRR25023305_1_val_1_bismark_bt2_pe.bismark.cov,cases,chr11,108093532,108093532,3.03030303030303,1,32,33
SRR25023305_1_val_1_bismark_bt2_pe.bismark.cov,cases,chr11,108093538,108093538,0.0,0,43,43
SRR25023305_1_val_1_bismark_bt2_pe.bismark.cov,cases,chr11,108093560,108093560,1.21457489878543,6,488,494
SRR25023305_1_val_1_bismark_bt2_pe.bismark.cov,cases,chr11,108093567,108093567,0.186915887850467,1,534,535
SRR25023305_1_val_1_bismark_bt2_pe.bismark.cov,cases,chr11,108093572,108093572,0.366300366300366,2,544,546
SRR25023305_1_val_1_bismark_bt2_pe.bismark.cov,cases,chr11,108093579,108093579,0.359066427289048,2,555,557
SRR25023305_1_val_1_bismark_bt2_pe.bismark.cov,cases,chr11,108093584,108093584,1.21107266435986,7,571,578
SRR25023305_1_val_1_bismark_bt2_pe.bismark.cov,cases,chr11,108093590,108093590,0.488599348534202,3,611,614
SRR25023305_1_val_1_bismark_bt2_pe.bismark.cov,cases,chr11,108093598,108093598,0.319488817891374,2,624,626
SRR25023305_1_val_1_bismark_bt2_pe.bismark.cov,cases,chr15,89786999,89786999,1.08108108108108,2,183,185
SRR25023305_1_val_1_bismark_bt2_pe.bismark.cov,cases,chr15,89787007,89787007,2.12765957446809,4,184,188
SRR25023305_1_val_1_bismark_bt2_pe.bismark.cov,cases,chr15,89787009,89787009,0.0,0,188,188
SRR25023305_1_val_1_bismark_bt2_pe.bismark.cov,cases,chr15,89787018,89787018,0.0,0,188,188
SRR25023305_1_val_1_bismark_bt2_pe.bismark.cov,cases,chr15,89787032,89787032,0.531914893617021,1,187,188
SRR25023305_1_val_1_bismark_bt2_pe.bismark.cov,cases,chr15,89787034,89787034,0.531914893617021,1,187,188
SRR25023305_1_val_1_bismark_bt2_pe.bismark.cov,cases,chr15,89787036,89787036,0.53475935828877,1,186,187
SRR25023305_1_val_1_bismark_bt2_pe.bismark.cov,cases,chr15,89787045,89787045,0.0,0,187,187
SRR25023305_1_val_1_bismark_bt2_pe.bismark.cov,cases,chr15,89787048,89787048,1.0752688172043,2,184,186
SRR25023305_1_val_1_bismark_bt2_pe.bismark.cov,cases,chr15,89787058,89787058,0.53475935828877,1,186,187
SRR25023305_1_val_1_bismark_bt2_pe.bismark.cov,cases,chr15,89787060,89787060,1.60427807486631,3,184,187
SRR25023305_1_val_1_bismark_bt2_pe.bismark.cov,cases,chr15,89787066,89787066,0.0,0,187,187
SRR25023305_1_val_1_bismark_bt2_pe.bismark.cov,cases,chr15,89787077,89787077,0.0,0,187,187
SRR25023305_1_val_1_bismark_bt2_pe.bismark.cov,cases,chr15,89787087,89787087,0.0,0,186,186
SRR25023305_1_val_1_bismark_bt2_pe.bismark.cov,cases,chr15,89787103,89787103,0.0,0,186,186
SRR25023305_1_val_1_bismark_bt2_pe.bismark.cov,cases,chr15,89787109,89787109,1.08108108108108,2,183,185
SRR25023305_1_val_1_bismark_bt2_pe.bismark.cov,cases,chr15,89787113,89787113,0.0,0,185,185
SRR25023305_1_val_1_bismark_bt2_pe.bismark.cov,cases,chr15,89787120,89787120,0.0,0,185,185
SRR25023305_1_val_1_bismark_bt2_pe.bismark.cov,cases,chr15,89787150,89787150,0.546448087431694,1,182,183
SRR25023305_1_val_1_bismark_bt2_pe.bismark.cov,cases,chr15,89787154,89787154,0.549450549450549,1,181,182
SRR25023305_1_val_1_bismark_bt2_pe.bismark.cov,cases,chr15,89787164,89787164,0.568181818181818,1,175,176
SRR25023305_1_val_1_bismark_bt2_pe.bismark.cov,cases,chr15,89787168,89787168,1.13636363636364,2,174,176
SRR25023305_1_val_1_bismark_bt2_pe.bismark.cov,cases,chr15,89787171,89787171,0.0,0,174,174
SRR25023305_1_val_1_bismark_bt2_pe.bismark.cov,cases,chr15,89787182,89787182,0.0,0,173,173
SRR25023305_1_val_1_bismark_bt2_pe.bismark.cov,cases,chr15,89787184,89787184,1.16279069767442,2,170,172
SRR25023305_1_val_1_bismark_bt2_pe.bismark.cov,cases,chr15,89787190,89787190,1.19047619047619,2,166,168
SRR25023305_1_val_1_bismark_bt2_pe.bismark.cov,cases,chr15,89787205,89787205,0.0,0,156,156
SRR25023305_1_val_1_bismark_bt2_pe.bismark.cov,cases,chr15,89787212,89787212,1.66666666666667,2,118,120
SRR25023305_1_val_1_bismark_bt2_pe.bismark.cov,cases,chr15,89787223,89787223,0.0,0,91,91
SRR25023305_1_val_1_bismark_bt2_pe.bismark.cov,cases,chr15,89787226,89787226,0.0,0,93,93
SRR25023305_1_val_1_bismark_bt2_pe.bismark.cov,cases,chr15,89787238,89787238,0.0,0,104,104
SRR25023305_1_val_1_bismark_bt2_pe.bismark.cov,cases,chr15,89787260,89787260,0.0,0,124,124
SRR25023305_1_val_1_bismark_bt2_pe.bismark.cov,cases,chr15,89787272,89787272,0.0,0,127,127
SRR25023305_1_val_1_bismark_bt2_pe.bismark.cov,cases,chr15,89787288,89787288,0.0,0,147,147
SRR25023305_1_val_1_bismark_bt2_pe.bismark.cov,cases,chr15,89787293,89787293,0.0,0,153,153
SRR25023305_1_val_1_bismark_bt2_pe.bismark.cov,cases,chr15,89787295,89787295,0.0,0,157,157
SRR25023305_1_val_1_bismark_bt2_pe.bismark.cov,cases,chr15,89787304,89787304,0.0,0,167,167
SRR25023305_1_val_1_bismark_bt2_pe.bismark.cov,cases,chr15,89787335,89787335,0.0,0,184,184
SRR25023305_1_val_1_bismark_bt2_pe.bismark.cov,cases,chr14,45604787,45604787,0.332225913621262,1,300,301
SRR25023305_1_val_1_bismark_bt2_pe.bismark.cov,cases,chr14,45604794,45604794,0.332225913621262,1,300,301
SRR25023305_1_val_1_bismark_bt2_pe.bismark.cov,cases,chr17,13571499,13571499,81.8181818181818,18,4,22
SRR25023305_1_val_1_bismark_bt2_pe.bismark.cov,cases,chr17,13571583,13571583,91.6666666666667,22,2,24
SRR25023305_1_val_1_bismark_bt2_pe.bismark.cov,cases,chr17,13571613,13571613,70.8333333333333,17,7,24
SRR25023305_1_val_1_bismark_bt2_pe.bismark.cov,cases,chr17,41277106,41277106,1.67427701674277,33,1938,1971
SRR25023305_1_val_1_bismark_bt2_pe.bismark.cov,cases,chr17,41277115,41277115,1.26710593005575,25,1948,1973
SRR25023305_1_val_1_bismark_bt2_pe.bismark.cov,cases,chr17,41277117,41277117,1.57520325203252,31,1937,1968
SRR25023305_1_val_1_bismark_bt2_pe.bismark.cov,cases,chr17,41277153,41277153,1.1207335710647,22,1941,1963
SRR25023305_1_val_1_bismark_bt2_pe.bismark.cov,cases,chr17,41277160,41277160,1.32315521628499,26,1939,1965
SRR25023305_1_val_1_bismark_bt2_pe.bismark.cov,cases,chr17,41277174,41277174,1.11902339776195,22,1944,1966
SRR25023305_1_val_1_bismark_bt2_pe.bismark.cov,cases,chr17,41277187,41277187,8.3073727933541,160,1766,1926
SRR25023305_1_val_1_bismark_bt2_pe.bismark.cov,cases,chr17,41277214,41277214,1.41557128412538,28,1950,1978
SRR25023305_1_val_1_bismark_bt2_pe.bismark.cov,cases,chr17,41277232,41277232,1.06060606060606,21,1959,1980
SRR25023305_1_val_1_bismark_bt2_pe.bismark.cov,cases,chr17,56769746,56769746,94.2028985507246,130,8,138
SRR25023305_1_val_1_bismark_bt2_pe.bismark.cov,cases,chr17,56769760,56769760,87.7697841726619,122,17,139
SRR25023305_1_val_1_bismark_bt2_pe.bismark.cov,cases,chr17,56769767,56769767,71.9424460431655,100,39,139
SRR25023305_1_val_1_bismark_bt2_pe.bismark.cov,cases,chr17,56769830,56769830,0.757575757575758,1,131,132
SRR25023305_1_val_1_bismark_bt2_pe.bismark.cov,cases,chr17,56769866,56769866,0.0,0,133,133
SRR25023305_1_val_1_bismark_bt2_pe.bismark.cov,cases,chr17,56769883,56769883,0.75187969924812,1,132,133
SRR25023305_1_val_1_bismark_bt2_pe.bismark.cov,cases,chr17,56769891,56769891,0.0,0,134,134
SRR25023305_1_val_1_bismark_bt2_pe.bismark.cov,cases,chr17,56769895,56769895,0.0,0,134,134
SRR25023305_1_val_1_bismark_bt2_pe.bismark.cov,cases,chr17,56769904,56769904,2.23880597014925,3,131,134
SRR25023305_1_val_1_bismark_bt2_pe.bismark.cov,cases,chr17,56769912,56769912,0.0,0,134,134
SRR25023305_1_val_1_bismark_bt2_pe.bismark.cov,cases,chr17,56769922,56769922,0.0,0,132,132
SRR25023305_1_val_1_bismark_bt2_pe.bismark.cov,cases,chr17,56769929,56769929,0.0,0,132,132
SRR25023305_1_val_1_bismark_bt2_pe.bismark.cov,cases,chr17,56769936,56769936,0.769230769230769,1,129,130
SRR25023305_1_val_1_bismark_bt2_pe.bismark.cov,cases,chr17,56769941,56769941,2.30769230769231,3,127,130
SRR25023305_1_val_1_bismark_bt2_pe.bismark.cov,cases,chr17,56769944,56769944,1.53846153846154,2,128,130
SRR25023305_1_val_1_bismark_bt2_pe.bismark.cov,cases,chr17,56769948,56769948,0.0,0,130,130
SRR25023305_1_val_1_bismark_bt2_pe.bismark.cov,cases,chr17,56769956,56769956,0.0,0,121,121
SRR25023305_1_val_1_bismark_bt2_pe.bismark.cov,cases,chr17,56769962,56769962,1.78571428571429,2,110,112
SRR25023305_1_val_1_bismark_bt2_pe.bismark.cov,cases,chr17,56769966,56769966,0.0,0,108,108
SRR25023305_1_val_1_bismark_bt2_pe.bismark.cov,cases,chr17,56769982,56769982,0.925925925925926,1,107,108
SRR25023305_1_val_1_bismark_bt2_pe.bismark.cov,cases,chr17,56770003,56770003,0.0,0,115,115
SRR25023305_1_val_1_bismark_bt2_pe.bismark.cov,cases,chr17,56770008,56770008,0.0,0,117,117
SRR25023305_1_val_1_bismark_bt2_pe.bismark.cov,cases,chr17,56770010,56770010,0.0,0,118,118
SRR25023305_1_val_1_bismark_bt2_pe.bismark.cov,cases,chr17,56770018,56770018,0.0,0,123,123
SRR25023305_1_val_1_bismark_bt2_pe.bismark.cov,cases,chr17,56770023,56770023,0.793650793650794,1,125,126
SRR25023305_1_val_1_bismark_bt2_pe.bismark.cov,cases,chr17,56770038,56770038,1.5625,2,126,128
SRR25023305_1_val_1_bismark_bt2_pe.bismark.cov,cases,chr17,56770057,56770057,0.0,0,127,127
SRR25023305_1_val_1_bismark_bt2_pe.bismark.cov,cases,chr17,56770069,56770069,0.0,0,126,126
SRR25023305_1_val_1_bismark_bt2_pe.bismark.cov,cases,chr17,56770074,56770074,0.0,0,128,128
SRR25023305_1_val_1_bismark_bt2_pe.bismark.cov,cases,chr17,56770093,56770093,0.0,0,129,129
SRR25023305_1_val_1_bismark_bt2_pe.bismark.cov,cases,chr17,59940970,59940970,0.37593984962406,1,265,266
SRR25023305_1_val_1_bismark_bt2_pe.bismark.cov,cases,chr17,59940975,59940975,1.13207547169811,3,262,265
SRR25023305_1_val_1_bismark_bt2_pe.bismark.cov,cases,chr17,59940988,59940988,0.0,0,265,265
SRR25023305_1_val_1_bismark_bt2_pe.bismark.cov,cases,chr17,59940997,59940997,0.380228136882129,1,262,263
SRR25023305_1_val_1_bismark_bt2_pe.bismark.cov,cases,chr17,59941017,59941017,0.0,0,155,155
SRR25023305_1_val_1_bismark_bt2_pe.bismark.cov,cases,chr17,59941051,59941051,0.0,0,266,266
SRR25023305_1_val_1_bismark_bt2_pe.bismark.cov,cases,chr17,59941053,59941053,0.340136054421769,1,293,294
SRR25023305_1_val_1_bismark_bt2_pe.bismark.cov,cases,chr17,59941056,59941056,0.0,0,265,265
SRR25023305_1_val_1_bismark_bt2_pe.bismark.cov,cases,chr17,59941067,59941067,0.735294117647059,2,270,272
SRR25023305_1_val_1_bismark_bt2_pe.bismark.cov,cases,chr17,59941110,59941110,0.0,0,308,308
SRR25023305_1_val_1_bismark_bt2_pe.bismark.cov,cases,chr17,59941133,59941133,0.32258064516129,1,309,310
SRR25023305_1_val_1_bismark_bt2_pe.bismark.cov,cases,chr17,59941136,59941136,0.967741935483871,3,307,310
SRR25023305_1_val_1_bismark_bt2_pe.bismark.cov,cases,chr17,59941187,59941187,0.323624595469256,1,308,309
SRR25023305_1_val_1_bismark_bt2_pe.bismark.cov,cases,chr17,59941191,59941191,0.324675324675325,1,307,308
SRR25023305_1_val_1_bismark_bt2_pe.bismark.cov,cases,chr17,59941201,59941201,0.873362445414847,2,227,229
SRR25023305_1_val_1_bismark_bt2_pe.bismark.cov,cases,chr17,59941202,59941202,0.0,0,73,73
SRR25023305_1_val_1_bismark_bt2_pe.bismark.cov,cases,chr17,76325846,76325846,50.6329113924051,40,39,79
SRR25023305_1_val_1_bismark_bt2_pe.bismark.cov,cases,chr17,76325851,76325851,48.1012658227848,38,41,79
SRR25023305_1_val_1_bismark_bt2_pe.bismark.cov,cases,chr17,76325865,76325865,30.379746835443,24,55,79
SRR25023305_1_val_1_bismark_bt2_pe.bismark.cov,cases,chr17,76325979,76325979,74.6835443037975,59,20,79
SRR25023305_1_val_1_bismark_bt2_pe.bismark.cov,cases,chrX,14891454,14891454,25.4420600858369,1482,4343,5825
SRR25023305_1_val_1_bismark_bt2_pe.bismark.cov,cases,chrX,14891470,14891470,19.3515182707154,1128,4701,5829
SRR25023305_1_val_1_bismark_bt2_pe.bismark.cov,cases,chrX,14891474,14891474,30.5831903945111,1783,4047,5830
SRR25023305_1_val_1_bismark_bt2_pe.bismark.cov,cases,chrX,14891488,14891488,25.1757845995541,1468,4363,5831
SRR25023305_1_val_1_bismark_bt2_pe.bismark.cov,cases,chrX,14891493,14891493,41.8668496911462,2440,3388,5828
SRR25023305_1_val_1_bismark_bt2_pe.bismark.cov,cases,chrX,14891496,14891496,31.1503514486542,1817,4016,5833
SRR25023305_1_val_1_bismark_bt2_pe.bismark.cov,cases,chrX,14891499,14891499,22.3519313304721,1302,4523,5825
SRR25023305_1_val_1_bismark_bt2_pe.bismark.cov,cases,chrX,14891509,14891509,41.2360515021459,2402,3423,5825
SRR25023305_1_val_1_bismark_bt2_pe.bismark.cov,cases,chrX,14891516,14891516,41.8225501973571,2437,3390,5827
SRR25023305_1_val_1_bismark_bt2_pe.bismark.cov,cases,chrX,14891524,14891524,22.5407725321888,1313,4512,5825
SRR25023305_1_val_1_bismark_bt2_pe.bismark.cov,cases,chrX,14891526,14891526,31.8462594371997,1856,3972,5828
SRR25023305_1_val_1_bismark_bt2_pe.bismark.cov,cases,chrX,14891530,14891530,34.1915550978373,1992,3834,5826
SRR25023305_1_val_1_bismark_bt2_pe.bismark.cov,cases,chr16,23652769,23652769,1.35135135135135,6,438,444
SRR25023305_1_val_1_bismark_bt2_pe.bismark.cov,cases,chr16,23652783,23652783,1.12107623318386,5,441,446
SRR25023305_1_val_1_bismark_bt2_pe.bismark.cov,cases,chr16,23652787,23652787,0.677200902934537,3,440,443
SRR25023305_1_val_1_bismark_bt2_pe.bismark.cov,cases,chr16,23652797,23652797,0.91324200913242,4,434,438
SRR25023305_1_val_1_bismark_bt2_pe.bismark.cov,cases,chr16,23652818,23652818,0.680272108843537,3,438,441
SRR25023305_1_val_1_bismark_bt2_pe.bismark.cov,cases,chr16,23652838,23652838,0.453514739229025,2,439,441
SRR25023305_1_val_1_bismark_bt2_pe.bismark.cov,cases,chr16,23652857,23652857,1.55555555555556,7,443,450
SRR25023305_1_val_1_bismark_bt2_pe.bismark.cov,cases,chr16,23652860,23652860,0.444444444444444,2,448,450
SRR25023305_1_val_1_bismark_bt2_pe.bismark.cov,cases,chr16,23652876,23652876,1.33333333333333,6,444,450
SRR25023305_1_val_1_bismark_bt2_pe.bismark.cov,cases,chr16,23652906,23652906,1.78571428571429,8,440,448
SRR25023305_1_val_1_bismark_bt2_pe.bismark.cov,cases,chr16,23652911,23652911,0.446428571428571,2,446,448
SRR25023305_1_val_1_bismark_bt2_pe.bismark.cov,cases,chr16,23652916,23652916,1.35746606334842,6,436,442
SRR25023305_1_val_1_bismark_bt2_pe.bismark.cov,cases,chr16,23652918,23652918,1.55902004454343,7,442,449
SRR25023305_1_val_1_bismark_bt2_pe.bismark.cov,cases,chr7,6048869,6048869,0.591465990705534,28,4706,4734
SRR25023305_1_val_1_bismark_bt2_pe.bismark.cov,cases,chr7,6048876,6048876,0.802873441791675,38,4695,4733
SRR25023305_1_val_1_bismark_bt2_pe.bismark.cov,cases,chr7,6048884,6048884,0.486566532684578,23,4704,4727
SRR25023305_1_val_1_bismark_bt2_pe.bismark.cov,cases,chr7,6048888,6048888,0.613496932515337,29,4698,4727
SRR25023305_1_val_1_bismark_bt2_pe.bismark.cov,cases,chr7,6048892,6048892,0.550148116800677,26,4700,4726
SRR25023305_1_val_1_bismark_bt2_pe.bismark.cov,cases,chr7,6048904,6048904,0.107181136120043,1,932,933
SRR25023305_1_val_1_bismark_bt2_pe.bismark.cov,cases,chr7,6048918,6048918,0.674820750738085,32,4710,4742
SRR25023305_1_val_1_bismark_bt2_pe.bismark.cov,cases,chr7,6048925,6048925,0.526870389884089,25,4720,4745
SRR25023305_1_val_1_bismark_bt2_pe.bismark.cov,cases,chr7,6048928,6048928,0.632111251580278,30,4716,4746
SRR25023305_1_val_1_bismark_bt2_pe.bismark.cov,cases,chr7,6048940,6048940,0.907364422874024,43,4696,4739
SRR25023305_1_val_1_bismark_bt2_pe.bismark.cov,cases,chr7,6048951,6048951,0.358649789029536,17,4723,4740
SRR25023305_1_val_1_bismark_bt2_pe.bismark.cov,cases,chr7,6048966,6048966,0.590468156895825,28,4714,4742
SRR25023305_1_val_1_bismark_bt2_pe.bismark.cov,cases,chr7,6048968,6048968,0.486566532684578,23,4704,4727
