ID,Type,Chr,Start,End,Met_perc,Cyt_Met,Cyt_NoMet,Depth
SRR25023039_1_val_1_bismark_bt2_pe.bismark.cov,controls,chr3,37034307,37034307,99.95085995086,2034,1,2035
SRR25023039_1_val_1_bismark_bt2_pe.bismark.cov,controls,chr3,37034316,37034316,0.591133004926108,12,2018,2030
SRR25023039_1_val_1_bismark_bt2_pe.bismark.cov,controls,chr3,37034324,37034324,0.542941757156959,11,2015,2026
SRR25023039_1_val_1_bismark_bt2_pe.bismark.cov,controls,chr3,37034330,37034330,0.246791707798618,5,2021,2026
SRR25023039_1_val_1_bismark_bt2_pe.bismark.cov,controls,chr3,37034344,37034344,0.939663699307616,19,2003,2022
SRR25023039_1_val_1_bismark_bt2_pe.bismark.cov,controls,chr3,37034346,37034346,0.246913580246914,5,2020,2025
SRR25023039_1_val_1_bismark_bt2_pe.bismark.cov,controls,chr3,37034348,37034348,0.939663699307616,19,2003,2022
SRR25023039_1_val_1_bismark_bt2_pe.bismark.cov,controls,chr3,37034352,37034352,1.08641975308642,22,2003,2025
SRR25023039_1_val_1_bismark_bt2_pe.bismark.cov,controls,chr3,37034355,37034355,1.13692535837865,23,2000,2023
SRR25023039_1_val_1_bismark_bt2_pe.bismark.cov,controls,chr3,37034359,37034359,1.0853478046374,22,2005,2027
SRR25023039_1_val_1_bismark_bt2_pe.bismark.cov,controls,chr3,37034369,37034369,1.08588351431392,22,2004,2026
SRR25023039_1_val_1_bismark_bt2_pe.bismark.cov,controls,chr3,37034373,37034373,0.641658440276407,13,2013,2026
SRR25023039_1_val_1_bismark_bt2_pe.bismark.cov,controls,chr3,37034382,37034382,0.641341884558461,13,2014,2027
SRR25023039_1_val_1_bismark_bt2_pe.bismark.cov,controls,chr3,37034394,37034394,0.839091806515301,17,2009,2026
SRR25023039_1_val_1_bismark_bt2_pe.bismark.cov,controls,chr3,37034402,37034402,1.0365251727542,21,2005,2026
SRR25023039_1_val_1_bismark_bt2_pe.bismark.cov,controls,chr3,37034409,37034409,1.28205128205128,26,2002,2028
SRR25023039_1_val_1_bismark_bt2_pe.bismark.cov,controls,chr3,37034412,37034412,0.59142434696895,12,2017,2029
SRR25023039_1_val_1_bismark_bt2_pe.bismark.cov,controls,chr3,37034414,37034414,0.740009866798224,15,2012,2027
SRR25023039_1_val_1_bismark_bt2_pe.bismark.cov,controls,chr3,37034418,37034418,0.889328063241107,18,2006,2024
SRR25023039_1_val_1_bismark_bt2_pe.bismark.cov,controls,chr3,37034420,37034420,0.29585798816568,6,2022,2028
SRR25023039_1_val_1_bismark_bt2_pe.bismark.cov,controls,chr3,37034430,37034430,0.59142434696895,12,2017,2029
SRR25023039_1_val_1_bismark_bt2_pe.bismark.cov,controls,chr3,37034438,37034438,0.443349753694581,9,2021,2030
SRR25023039_1_val_1_bismark_bt2_pe.bismark.cov,controls,chr3,37034441,37034441,0.641341884558461,13,2014,2027
SRR25023039_1_val_1_bismark_bt2_pe.bismark.cov,controls,chr3,37034466,37034466,99.9506416584403,2025,1,2026
SRR25023039_1_val_1_bismark_bt2_pe.bismark.cov,controls,chr3,37034997,37034997,0.261894369271061,6,2285,2291
SRR25023039_1_val_1_bismark_bt2_pe.bismark.cov,controls,chr3,37035012,37035012,0.4359197907585,10,2284,2294
SRR25023039_1_val_1_bismark_bt2_pe.bismark.cov,controls,chr3,37035032,37035032,0.34980323567993,8,2279,2287
SRR25023039_1_val_1_bismark_bt2_pe.bismark.cov,controls,chr3,37035043,37035043,0.392670157068063,9,2283,2292
SRR25023039_1_val_1_bismark_bt2_pe.bismark.cov,controls,chr3,37035047,37035047,0.786026200873363,18,2272,2290
SRR25023039_1_val_1_bismark_bt2_pe.bismark.cov,controls,chr3,37035063,37035063,0.611620795107034,14,2275,2289
SRR25023039_1_val_1_bismark_bt2_pe.bismark.cov,controls,chr3,37035066,37035066,0.393184796854522,9,2280,2289
SRR25023039_1_val_1_bismark_bt2_pe.bismark.cov,controls,chr3,37035074,37035074,0.393356643356643,9,2279,2288
SRR25023039_1_val_1_bismark_bt2_pe.bismark.cov,controls,chr3,37035090,37035090,0.613228208497591,14,2269,2283
SRR25023039_1_val_1_bismark_bt2_pe.bismark.cov,controls,chr3,37035095,37035095,0.525164113785558,12,2273,2285
SRR25023039_1_val_1_bismark_bt2_pe.bismark.cov,controls,chr3,37035097,37035097,0.786713286713287,18,2270,2288
SRR25023039_1_val_1_bismark_bt2_pe.bismark.cov,controls,chr3,37035100,37035100,0.69960647135986,16,2271,2287
SRR25023039_1_val_1_bismark_bt2_pe.bismark.cov,controls,chr3,37035117,37035117,0.261894369271061,6,2285,2291
SRR25023039_1_val_1_bismark_bt2_pe.bismark.cov,controls,chr3,142297977,142297977,1.72413793103448,4,228,232
SRR25023039_1_val_1_bismark_bt2_pe.bismark.cov,controls,chr3,142298019,142298019,1.71673819742489,4,229,233
SRR25023039_1_val_1_bismark_bt2_pe.bismark.cov,controls,chr3,142298045,142298045,0.858369098712446,2,231,233
SRR25023039_1_val_1_bismark_bt2_pe.bismark.cov,controls,chr3,142298054,142298054,3.41880341880342,8,226,234
SRR25023039_1_val_1_bismark_bt2_pe.bismark.cov,controls,chr13,32889392,32889392,19.31330472103,360,1504,1864
SRR25023039_1_val_1_bismark_bt2_pe.bismark.cov,controls,chr13,32889434,32889434,3.6578805809575,68,1791,1859
SRR25023039_1_val_1_bismark_bt2_pe.bismark.cov,controls,chr13,32889461,32889461,1.18406889128095,22,1836,1858
SRR25023039_1_val_1_bismark_bt2_pe.bismark.cov,controls,chr13,32889470,32889470,0.483870967741935,9,1851,1860
SRR25023039_1_val_1_bismark_bt2_pe.bismark.cov,controls,chr13,32889484,32889484,0.377358490566038,7,1848,1855
SRR25023039_1_val_1_bismark_bt2_pe.bismark.cov,controls,chr10,89619506,89619506,98.1900452488688,217,4,221
SRR25023039_1_val_1_bismark_bt2_pe.bismark.cov,controls,chr10,89619510,89619510,99.0950226244344,219,2,221
SRR25023039_1_val_1_bismark_bt2_pe.bismark.cov,controls,chr10,89619512,89619512,97.737556561086,216,5,221
SRR25023039_1_val_1_bismark_bt2_pe.bismark.cov,controls,chr10,89619522,89619522,98.1900452488688,217,4,221
SRR25023039_1_val_1_bismark_bt2_pe.bismark.cov,controls,chr10,89619550,89619550,96.3636363636364,212,8,220
SRR25023039_1_val_1_bismark_bt2_pe.bismark.cov,controls,chr10,89619555,89619555,95.4337899543379,209,10,219
SRR25023039_1_val_1_bismark_bt2_pe.bismark.cov,controls,chr10,89619566,89619566,95.4128440366973,208,10,218
SRR25023039_1_val_1_bismark_bt2_pe.bismark.cov,controls,chr10,89619580,89619580,93.6073059360731,205,14,219
SRR25023039_1_val_1_bismark_bt2_pe.bismark.cov,controls,chr15,89786999,89786999,1.20481927710843,1,82,83
SRR25023039_1_val_1_bismark_bt2_pe.bismark.cov,controls,chr15,89787007,89787007,1.20481927710843,1,82,83
SRR25023039_1_val_1_bismark_bt2_pe.bismark.cov,controls,chr15,89787009,89787009,0.0,0,83,83
SRR25023039_1_val_1_bismark_bt2_pe.bismark.cov,controls,chr15,89787018,89787018,1.20481927710843,1,82,83
SRR25023039_1_val_1_bismark_bt2_pe.bismark.cov,controls,chr15,89787032,89787032,1.19047619047619,1,83,84
SRR25023039_1_val_1_bismark_bt2_pe.bismark.cov,controls,chr15,89787034,89787034,0.0,0,83,83
SRR25023039_1_val_1_bismark_bt2_pe.bismark.cov,controls,chr15,89787036,89787036,1.19047619047619,1,83,84
SRR25023039_1_val_1_bismark_bt2_pe.bismark.cov,controls,chr15,89787045,89787045,0.0,0,84,84
SRR25023039_1_val_1_bismark_bt2_pe.bismark.cov,controls,chr15,89787048,89787048,1.19047619047619,1,83,84
SRR25023039_1_val_1_bismark_bt2_pe.bismark.cov,controls,chr15,89787058,89787058,0.0,0,84,84
SRR25023039_1_val_1_bismark_bt2_pe.bismark.cov,controls,chr15,89787060,89787060,0.0,0,84,84
SRR25023039_1_val_1_bismark_bt2_pe.bismark.cov,controls,chr15,89787066,89787066,0.0,0,84,84
SRR25023039_1_val_1_bismark_bt2_pe.bismark.cov,controls,chr15,89787077,89787077,0.0,0,83,83
SRR25023039_1_val_1_bismark_bt2_pe.bismark.cov,controls,chr15,89787087,89787087,1.20481927710843,1,82,83
SRR25023039_1_val_1_bismark_bt2_pe.bismark.cov,controls,chr15,89787103,89787103,0.0,0,83,83
SRR25023039_1_val_1_bismark_bt2_pe.bismark.cov,controls,chr15,89787109,89787109,0.0,0,79,79
SRR25023039_1_val_1_bismark_bt2_pe.bismark.cov,controls,chr15,89787113,89787113,0.0,0,83,83
SRR25023039_1_val_1_bismark_bt2_pe.bismark.cov,controls,chr15,89787120,89787120,0.0,0,83,83
SRR25023039_1_val_1_bismark_bt2_pe.bismark.cov,controls,chr15,89787150,89787150,1.21951219512195,1,81,82
SRR25023039_1_val_1_bismark_bt2_pe.bismark.cov,controls,chr15,89787154,89787154,0.0,0,80,80
SRR25023039_1_val_1_bismark_bt2_pe.bismark.cov,controls,chr15,89787164,89787164,0.0,0,76,76
SRR25023039_1_val_1_bismark_bt2_pe.bismark.cov,controls,chr15,89787168,89787168,0.0,0,75,75
SRR25023039_1_val_1_bismark_bt2_pe.bismark.cov,controls,chr15,89787171,89787171,1.42857142857143,1,69,70
SRR25023039_1_val_1_bismark_bt2_pe.bismark.cov,controls,chr15,89787182,89787182,1.61290322580645,1,61,62
SRR25023039_1_val_1_bismark_bt2_pe.bismark.cov,controls,chr15,89787184,89787184,0.0,0,61,61
SRR25023039_1_val_1_bismark_bt2_pe.bismark.cov,controls,chr15,89787190,89787190,0.0,0,55,55
SRR25023039_1_val_1_bismark_bt2_pe.bismark.cov,controls,chr15,89787205,89787205,2.12765957446809,1,46,47
SRR25023039_1_val_1_bismark_bt2_pe.bismark.cov,controls,chr15,89787212,89787212,0.0,0,45,45
SRR25023039_1_val_1_bismark_bt2_pe.bismark.cov,controls,chr15,89787223,89787223,0.0,0,32,32
SRR25023039_1_val_1_bismark_bt2_pe.bismark.cov,controls,chr15,89787226,89787226,0.0,0,40,40
SRR25023039_1_val_1_bismark_bt2_pe.bismark.cov,controls,chr15,89787238,89787238,0.0,0,43,43
SRR25023039_1_val_1_bismark_bt2_pe.bismark.cov,controls,chr15,89787260,89787260,0.0,0,52,52
SRR25023039_1_val_1_bismark_bt2_pe.bismark.cov,controls,chr15,89787272,89787272,0.0,0,53,53
SRR25023039_1_val_1_bismark_bt2_pe.bismark.cov,controls,chr15,89787288,89787288,1.66666666666667,1,59,60
SRR25023039_1_val_1_bismark_bt2_pe.bismark.cov,controls,chr15,89787293,89787293,1.61290322580645,1,61,62
SRR25023039_1_val_1_bismark_bt2_pe.bismark.cov,controls,chr15,89787295,89787295,0.0,0,61,61
SRR25023039_1_val_1_bismark_bt2_pe.bismark.cov,controls,chr15,89787304,89787304,0.0,0,64,64
SRR25023039_1_val_1_bismark_bt2_pe.bismark.cov,controls,chr15,89787335,89787335,1.42857142857143,1,69,70
SRR25023039_1_val_1_bismark_bt2_pe.bismark.cov,controls,chr14,45604787,45604787,2.28571428571429,4,171,175
SRR25023039_1_val_1_bismark_bt2_pe.bismark.cov,controls,chr14,45604794,45604794,0.0,0,175,175
SRR25023039_1_val_1_bismark_bt2_pe.bismark.cov,controls,chr2,47596828,47596828,1.74418604651163,15,845,860
SRR25023039_1_val_1_bismark_bt2_pe.bismark.cov,controls,chr2,47596830,47596830,3.82387022016222,33,830,863
SRR25023039_1_val_1_bismark_bt2_pe.bismark.cov,controls,chr2,47596840,47596840,3.34872979214781,29,837,866
SRR25023039_1_val_1_bismark_bt2_pe.bismark.cov,controls,chr2,47596849,47596849,9.61761297798378,83,780,863
SRR25023039_1_val_1_bismark_bt2_pe.bismark.cov,controls,chr2,47596853,47596853,7.83847980997625,33,388,421
SRR25023039_1_val_1_bismark_bt2_pe.bismark.cov,controls,chr2,47596858,47596858,5.31791907514451,46,819,865
SRR25023039_1_val_1_bismark_bt2_pe.bismark.cov,controls,chr2,47596862,47596862,3.24449594438007,28,835,863
SRR25023039_1_val_1_bismark_bt2_pe.bismark.cov,controls,chr2,47596869,47596869,10.2890173410405,89,776,865
SRR25023039_1_val_1_bismark_bt2_pe.bismark.cov,controls,chr2,47596883,47596883,9.61761297798378,83,780,863
SRR25023039_1_val_1_bismark_bt2_pe.bismark.cov,controls,chr2,47596885,47596885,2.56111757857974,22,837,859
SRR25023039_1_val_1_bismark_bt2_pe.bismark.cov,controls,chr2,47596887,47596887,3.58796296296296,31,833,864
SRR25023039_1_val_1_bismark_bt2_pe.bismark.cov,controls,chr2,47596897,47596897,3.8150289017341,33,832,865
SRR25023039_1_val_1_bismark_bt2_pe.bismark.cov,controls,chr2,47596900,47596900,3.00925925925926,26,838,864
SRR25023039_1_val_1_bismark_bt2_pe.bismark.cov,controls,chr2,47596907,47596907,1.85614849187935,16,846,862
SRR25023039_1_val_1_bismark_bt2_pe.bismark.cov,controls,chr2,47596912,47596912,1.73812282734647,15,848,863
SRR25023039_1_val_1_bismark_bt2_pe.bismark.cov,controls,chr2,47596930,47596930,3.34486735870819,29,838,867
SRR25023039_1_val_1_bismark_bt2_pe.bismark.cov,controls,chr2,47596942,47596942,5.08670520231214,44,821,865
SRR25023039_1_val_1_bismark_bt2_pe.bismark.cov,controls,chr2,47630224,47630224,0.898876404494382,4,441,445
SRR25023039_1_val_1_bismark_bt2_pe.bismark.cov,controls,chr2,47630227,47630227,0.224215246636771,1,445,446
SRR25023039_1_val_1_bismark_bt2_pe.bismark.cov,controls,chr2,47630233,47630233,1.59453302961276,7,432,439
SRR25023039_1_val_1_bismark_bt2_pe.bismark.cov,controls,chr2,47630237,47630237,0.224215246636771,1,445,446
SRR25023039_1_val_1_bismark_bt2_pe.bismark.cov,controls,chr2,47630240,47630240,0.672645739910314,3,443,446
SRR25023039_1_val_1_bismark_bt2_pe.bismark.cov,controls,chr2,47630244,47630244,0.898876404494382,4,441,445
SRR25023039_1_val_1_bismark_bt2_pe.bismark.cov,controls,chr2,47630251,47630251,1.12359550561798,5,440,445
SRR25023039_1_val_1_bismark_bt2_pe.bismark.cov,controls,chr2,47630265,47630265,0.0,0,443,443
SRR25023039_1_val_1_bismark_bt2_pe.bismark.cov,controls,chr2,47630292,47630292,0.448430493273543,2,444,446
SRR25023039_1_val_1_bismark_bt2_pe.bismark.cov,controls,chr2,47630294,47630294,1.34529147982063,6,440,446
SRR25023039_1_val_1_bismark_bt2_pe.bismark.cov,controls,chr2,58468506,58468506,0.0,0,106,106
SRR25023039_1_val_1_bismark_bt2_pe.bismark.cov,controls,chr2,58468513,58468513,0.952380952380952,1,104,105
SRR25023039_1_val_1_bismark_bt2_pe.bismark.cov,controls,chr2,58468519,58468519,0.0,0,104,104
SRR25023039_1_val_1_bismark_bt2_pe.bismark.cov,controls,chr2,58468523,58468523,0.0,0,100,100
SRR25023039_1_val_1_bismark_bt2_pe.bismark.cov,controls,chr2,58468527,58468527,0.0,0,102,102
SRR25023039_1_val_1_bismark_bt2_pe.bismark.cov,controls,chr2,58468530,58468530,0.0,0,100,100
SRR25023039_1_val_1_bismark_bt2_pe.bismark.cov,controls,chr2,58468532,58468532,0.0,0,98,98
SRR25023039_1_val_1_bismark_bt2_pe.bismark.cov,controls,chr2,58468537,58468537,1.0,1,99,100
SRR25023039_1_val_1_bismark_bt2_pe.bismark.cov,controls,chr2,58468555,58468555,0.0,0,95,95
SRR25023039_1_val_1_bismark_bt2_pe.bismark.cov,controls,chr2,58468576,58468576,0.0,0,92,92
SRR25023039_1_val_1_bismark_bt2_pe.bismark.cov,controls,chr2,58468578,58468578,1.08695652173913,1,91,92
SRR25023039_1_val_1_bismark_bt2_pe.bismark.cov,controls,chr2,58468582,58468582,1.08695652173913,1,91,92
SRR25023039_1_val_1_bismark_bt2_pe.bismark.cov,controls,chr2,58468599,58468599,2.32558139534884,2,84,86
SRR25023039_1_val_1_bismark_bt2_pe.bismark.cov,controls,chr2,58468618,58468618,0.0,0,65,65
SRR25023039_1_val_1_bismark_bt2_pe.bismark.cov,controls,chr2,58468625,58468625,0.0,0,51,51
SRR25023039_1_val_1_bismark_bt2_pe.bismark.cov,controls,chr2,58468632,58468632,0.0,0,53,53
SRR25023039_1_val_1_bismark_bt2_pe.bismark.cov,controls,chr2,58468652,58468652,1.28205128205128,1,77,78
SRR25023039_1_val_1_bismark_bt2_pe.bismark.cov,controls,chr2,58468737,58468737,2.94117647058824,3,99,102
SRR25023039_1_val_1_bismark_bt2_pe.bismark.cov,controls,chr2,58468823,58468823,3.92156862745098,4,98,102
SRR25023039_1_val_1_bismark_bt2_pe.bismark.cov,controls,chr2,128051674,128051674,0.0,0,42,42
SRR25023039_1_val_1_bismark_bt2_pe.bismark.cov,controls,chr2,128051690,128051690,0.571428571428571,1,174,175
SRR25023039_1_val_1_bismark_bt2_pe.bismark.cov,controls,chr2,128051704,128051704,0.0,0,176,176
SRR25023039_1_val_1_bismark_bt2_pe.bismark.cov,controls,chr2,128051707,128051707,1.71428571428571,3,172,175
SRR25023039_1_val_1_bismark_bt2_pe.bismark.cov,controls,chr2,128051709,128051709,3.40909090909091,6,170,176
SRR25023039_1_val_1_bismark_bt2_pe.bismark.cov,controls,chr2,128051716,128051716,0.568181818181818,1,175,176
SRR25023039_1_val_1_bismark_bt2_pe.bismark.cov,controls,chr2,128051733,128051733,1.13636363636364,2,174,176
SRR25023039_1_val_1_bismark_bt2_pe.bismark.cov,controls,chr2,128051743,128051743,1.13636363636364,2,174,176
SRR25023039_1_val_1_bismark_bt2_pe.bismark.cov,controls,chr6,43543548,43543548,1.2448132780083,3,238,241
SRR25023039_1_val_1_bismark_bt2_pe.bismark.cov,controls,chr6,43543554,43543554,0.829875518672199,2,239,241
SRR25023039_1_val_1_bismark_bt2_pe.bismark.cov,controls,chr6,43543571,43543571,1.66666666666667,4,236,240
SRR25023039_1_val_1_bismark_bt2_pe.bismark.cov,controls,chr6,43543578,43543578,0.0,0,238,238
SRR25023039_1_val_1_bismark_bt2_pe.bismark.cov,controls,chr6,43543580,43543580,0.0,0,237,237
SRR25023039_1_val_1_bismark_bt2_pe.bismark.cov,controls,chr6,43543596,43543596,0.427350427350427,1,233,234
SRR25023039_1_val_1_bismark_bt2_pe.bismark.cov,controls,chr6,43543608,43543608,0.862068965517241,2,230,232
SRR25023039_1_val_1_bismark_bt2_pe.bismark.cov,controls,chr6,43543613,43543613,1.28755364806867,3,230,233
SRR25023039_1_val_1_bismark_bt2_pe.bismark.cov,controls,chr6,43543615,43543615,3.00429184549356,7,226,233
SRR25023039_1_val_1_bismark_bt2_pe.bismark.cov,controls,chr6,43543618,43543618,1.28205128205128,3,231,234
SRR25023039_1_val_1_bismark_bt2_pe.bismark.cov,controls,chr6,43543624,43543624,0.0,0,234,234
SRR25023039_1_val_1_bismark_bt2_pe.bismark.cov,controls,chr6,43543642,43543642,0.434782608695652,1,229,230
SRR25023039_1_val_1_bismark_bt2_pe.bismark.cov,controls,chr6,43543650,43543650,0.423728813559322,1,235,236
SRR25023039_1_val_1_bismark_bt2_pe.bismark.cov,controls,chr6,43543657,43543657,0.427350427350427,1,233,234
SRR25023039_1_val_1_bismark_bt2_pe.bismark.cov,controls,chr6,43543669,43543669,0.854700854700855,2,232,234
SRR25023039_1_val_1_bismark_bt2_pe.bismark.cov,controls,chr6,43543672,43543672,0.858369098712446,2,231,233
SRR25023039_1_val_1_bismark_bt2_pe.bismark.cov,controls,chr6,43543682,43543682,0.431034482758621,1,231,232
SRR25023039_1_val_1_bismark_bt2_pe.bismark.cov,controls,chr6,43543691,43543691,4.34782608695652,10,220,230
SRR25023039_1_val_1_bismark_bt2_pe.bismark.cov,controls,chr6,43543696,43543696,2.60869565217391,6,224,230
SRR25023039_1_val_1_bismark_bt2_pe.bismark.cov,controls,chr6,43543698,43543698,0.0,0,229,229
SRR25023039_1_val_1_bismark_bt2_pe.bismark.cov,controls,chr6,43543701,43543701,3.50877192982456,8,220,228
SRR25023039_1_val_1_bismark_bt2_pe.bismark.cov,controls,chr6,43543705,43543705,0.446428571428571,1,223,224
SRR25023039_1_val_1_bismark_bt2_pe.bismark.cov,controls,chr6,43543708,43543708,0.45045045045045,1,221,222
SRR25023039_1_val_1_bismark_bt2_pe.bismark.cov,controls,chr6,43543733,43543733,1.50753768844221,3,196,199
SRR25023039_1_val_1_bismark_bt2_pe.bismark.cov,controls,chr6,43543747,43543747,1.46341463414634,3,202,205
SRR25023039_1_val_1_bismark_bt2_pe.bismark.cov,controls,chr6,43543749,43543749,0.492610837438424,1,202,203
SRR25023039_1_val_1_bismark_bt2_pe.bismark.cov,controls,chr6,43543763,43543763,0.0,0,205,205
SRR25023039_1_val_1_bismark_bt2_pe.bismark.cov,controls,chr6,43543766,43543766,0.0,0,210,210
SRR25023039_1_val_1_bismark_bt2_pe.bismark.cov,controls,chr6,43543771,43543771,0.0,0,208,208
SRR25023039_1_val_1_bismark_bt2_pe.bismark.cov,controls,chr6,43543775,43543775,2.39234449760766,5,204,209
SRR25023039_1_val_1_bismark_bt2_pe.bismark.cov,controls,chr6,43543777,43543777,0.467289719626168,1,213,214
SRR25023039_1_val_1_bismark_bt2_pe.bismark.cov,controls,chr6,43543781,43543781,1.37614678899083,3,215,218
SRR25023039_1_val_1_bismark_bt2_pe.bismark.cov,controls,chr6,43543786,43543786,0.91324200913242,2,217,219
SRR25023039_1_val_1_bismark_bt2_pe.bismark.cov,controls,chr6,43543794,43543794,0.0,0,228,228
SRR25023039_1_val_1_bismark_bt2_pe.bismark.cov,controls,chr6,43543798,43543798,2.22222222222222,5,220,225
SRR25023039_1_val_1_bismark_bt2_pe.bismark.cov,controls,chr6,43543800,43543800,0.434782608695652,1,229,230
SRR25023039_1_val_1_bismark_bt2_pe.bismark.cov,controls,chr6,43543804,43543804,1.31004366812227,3,226,229
SRR25023039_1_val_1_bismark_bt2_pe.bismark.cov,controls,chr6,43543806,43543806,0.865800865800866,2,229,231
SRR25023039_1_val_1_bismark_bt2_pe.bismark.cov,controls,chr6,43543815,43543815,0.423728813559322,1,235,236
SRR25023039_1_val_1_bismark_bt2_pe.bismark.cov,controls,chr6,43543822,43543822,0.420168067226891,1,237,238
SRR25023039_1_val_1_bismark_bt2_pe.bismark.cov,controls,chr11,22647545,22647545,0.0,0,69,69
SRR25023039_1_val_1_bismark_bt2_pe.bismark.cov,controls,chr11,22647600,22647600,0.0,0,55,55
SRR25023039_1_val_1_bismark_bt2_pe.bismark.cov,controls,chr11,22647610,22647610,0.0,0,54,54
SRR25023039_1_val_1_bismark_bt2_pe.bismark.cov,controls,chr11,22647618,22647618,0.0,0,46,46
SRR25023039_1_val_1_bismark_bt2_pe.bismark.cov,controls,chr11,22647622,22647622,0.0,0,47,47
SRR25023039_1_val_1_bismark_bt2_pe.bismark.cov,controls,chr11,22647643,22647643,0.0,0,44,44
SRR25023039_1_val_1_bismark_bt2_pe.bismark.cov,controls,chr11,22647649,22647649,2.7027027027027,1,36,37
SRR25023039_1_val_1_bismark_bt2_pe.bismark.cov,controls,chr11,22647651,22647651,0.0,0,37,37
SRR25023039_1_val_1_bismark_bt2_pe.bismark.cov,controls,chr11,22647661,22647661,0.0,0,39,39
SRR25023039_1_val_1_bismark_bt2_pe.bismark.cov,controls,chr11,22647745,22647745,1.40845070422535,1,70,71
SRR25023039_1_val_1_bismark_bt2_pe.bismark.cov,controls,chr11,22647764,22647764,0.0,0,71,71
SRR25023039_1_val_1_bismark_bt2_pe.bismark.cov,controls,chr11,22647774,22647774,1.40845070422535,1,70,71
SRR25023039_1_val_1_bismark_bt2_pe.bismark.cov,controls,chr11,22647849,22647849,61.4285714285714,43,27,70
SRR25023039_1_val_1_bismark_bt2_pe.bismark.cov,controls,chr17,41277106,41277106,1.82648401826484,4,215,219
SRR25023039_1_val_1_bismark_bt2_pe.bismark.cov,controls,chr17,41277115,41277115,1.81818181818182,4,216,220
SRR25023039_1_val_1_bismark_bt2_pe.bismark.cov,controls,chr17,41277117,41277117,2.71493212669683,6,215,221
SRR25023039_1_val_1_bismark_bt2_pe.bismark.cov,controls,chr17,41277153,41277153,2.25225225225225,5,217,222
SRR25023039_1_val_1_bismark_bt2_pe.bismark.cov,controls,chr17,41277160,41277160,2.25225225225225,5,217,222
SRR25023039_1_val_1_bismark_bt2_pe.bismark.cov,controls,chr17,41277174,41277174,2.26244343891403,5,216,221
SRR25023039_1_val_1_bismark_bt2_pe.bismark.cov,controls,chr17,41277187,41277187,7.56302521008403,9,110,119
SRR25023039_1_val_1_bismark_bt2_pe.bismark.cov,controls,chr17,41277214,41277214,2.24215246636771,5,218,223
SRR25023039_1_val_1_bismark_bt2_pe.bismark.cov,controls,chr17,41277232,41277232,0.896860986547085,2,221,223
SRR25023039_1_val_1_bismark_bt2_pe.bismark.cov,controls,chr17,56769746,56769746,91.1764705882353,62,6,68
SRR25023039_1_val_1_bismark_bt2_pe.bismark.cov,controls,chr17,56769760,56769760,89.8550724637681,62,7,69
SRR25023039_1_val_1_bismark_bt2_pe.bismark.cov,controls,chr17,56769767,56769767,71.0144927536232,49,20,69
SRR25023039_1_val_1_bismark_bt2_pe.bismark.cov,controls,chr17,56769830,56769830,4.47761194029851,3,64,67
SRR25023039_1_val_1_bismark_bt2_pe.bismark.cov,controls,chr17,56769866,56769866,0.0,0,66,66
SRR25023039_1_val_1_bismark_bt2_pe.bismark.cov,controls,chr17,56769883,56769883,0.0,0,66,66
SRR25023039_1_val_1_bismark_bt2_pe.bismark.cov,controls,chr17,56769891,56769891,1.53846153846154,1,64,65
SRR25023039_1_val_1_bismark_bt2_pe.bismark.cov,controls,chr17,56769895,56769895,0.0,0,66,66
SRR25023039_1_val_1_bismark_bt2_pe.bismark.cov,controls,chr17,56769904,56769904,0.0,0,65,65
SRR25023039_1_val_1_bismark_bt2_pe.bismark.cov,controls,chr17,56769912,56769912,1.53846153846154,1,64,65
SRR25023039_1_val_1_bismark_bt2_pe.bismark.cov,controls,chr17,56769922,56769922,1.63934426229508,1,60,61
SRR25023039_1_val_1_bismark_bt2_pe.bismark.cov,controls,chr17,56769929,56769929,0.0,0,57,57
SRR25023039_1_val_1_bismark_bt2_pe.bismark.cov,controls,chr17,56769936,56769936,0.0,0,56,56
SRR25023039_1_val_1_bismark_bt2_pe.bismark.cov,controls,chr17,56769941,56769941,0.0,0,46,46
SRR25023039_1_val_1_bismark_bt2_pe.bismark.cov,controls,chr17,56769944,56769944,0.0,0,44,44
SRR25023039_1_val_1_bismark_bt2_pe.bismark.cov,controls,chr17,56769948,56769948,0.0,0,39,39
SRR25023039_1_val_1_bismark_bt2_pe.bismark.cov,controls,chr17,56769956,56769956,0.0,0,34,34
SRR25023039_1_val_1_bismark_bt2_pe.bismark.cov,controls,chr17,56769962,56769962,0.0,0,27,27
SRR25023039_1_val_1_bismark_bt2_pe.bismark.cov,controls,chr17,56769966,56769966,0.0,0,28,28
SRR25023039_1_val_1_bismark_bt2_pe.bismark.cov,controls,chr17,56769982,56769982,2.32558139534884,1,42,43
SRR25023039_1_val_1_bismark_bt2_pe.bismark.cov,controls,chr17,56770003,56770003,0.0,0,56,56
SRR25023039_1_val_1_bismark_bt2_pe.bismark.cov,controls,chr17,56770008,56770008,0.0,0,56,56
SRR25023039_1_val_1_bismark_bt2_pe.bismark.cov,controls,chr17,56770010,56770010,0.0,0,56,56
SRR25023039_1_val_1_bismark_bt2_pe.bismark.cov,controls,chr17,56770018,56770018,1.75438596491228,1,56,57
SRR25023039_1_val_1_bismark_bt2_pe.bismark.cov,controls,chr17,56770023,56770023,3.44827586206897,2,56,58
SRR25023039_1_val_1_bismark_bt2_pe.bismark.cov,controls,chr17,56770038,56770038,0.0,0,59,59
SRR25023039_1_val_1_bismark_bt2_pe.bismark.cov,controls,chr17,56770057,56770057,0.0,0,60,60
SRR25023039_1_val_1_bismark_bt2_pe.bismark.cov,controls,chr17,56770069,56770069,0.0,0,61,61
SRR25023039_1_val_1_bismark_bt2_pe.bismark.cov,controls,chr17,56770074,56770074,0.0,0,62,62
SRR25023039_1_val_1_bismark_bt2_pe.bismark.cov,controls,chr17,56770093,56770093,0.0,0,63,63
SRR25023039_1_val_1_bismark_bt2_pe.bismark.cov,controls,chr17,59940970,59940970,0.326086956521739,6,1834,1840
SRR25023039_1_val_1_bismark_bt2_pe.bismark.cov,controls,chr17,59940975,59940975,0.926430517711172,17,1818,1835
SRR25023039_1_val_1_bismark_bt2_pe.bismark.cov,controls,chr17,59940988,59940988,0.278706800445931,5,1789,1794
SRR25023039_1_val_1_bismark_bt2_pe.bismark.cov,controls,chr17,59940997,59940997,0.628930817610063,10,1580,1590
SRR25023039_1_val_1_bismark_bt2_pe.bismark.cov,controls,chr17,59941017,59941017,0.294334069168506,4,1355,1359
SRR25023039_1_val_1_bismark_bt2_pe.bismark.cov,controls,chr17,59941051,59941051,0.359281437125749,6,1664,1670
SRR25023039_1_val_1_bismark_bt2_pe.bismark.cov,controls,chr17,59941053,59941053,1.80078784468205,32,1745,1777
SRR25023039_1_val_1_bismark_bt2_pe.bismark.cov,controls,chr17,59941056,59941056,1.05017502917153,18,1696,1714
SRR25023039_1_val_1_bismark_bt2_pe.bismark.cov,controls,chr17,59941067,59941067,0.349243306169965,6,1712,1718
SRR25023039_1_val_1_bismark_bt2_pe.bismark.cov,controls,chr17,59941110,59941110,0.159659393294305,3,1876,1879
SRR25023039_1_val_1_bismark_bt2_pe.bismark.cov,controls,chr17,59941133,59941133,0.74034902168165,14,1877,1891
SRR25023039_1_val_1_bismark_bt2_pe.bismark.cov,controls,chr17,59941136,59941136,0.794070937003706,15,1874,1889
SRR25023039_1_val_1_bismark_bt2_pe.bismark.cov,controls,chr17,59941187,59941187,0.633245382585752,12,1883,1895
SRR25023039_1_val_1_bismark_bt2_pe.bismark.cov,controls,chr17,59941191,59941191,0.746268656716418,7,931,938
SRR25023039_1_val_1_bismark_bt2_pe.bismark.cov,controls,chr17,59941201,59941201,1.36887608069164,19,1369,1388
SRR25023039_1_val_1_bismark_bt2_pe.bismark.cov,controls,chr17,59941202,59941202,0.900900900900901,4,440,444
SRR25023039_1_val_1_bismark_bt2_pe.bismark.cov,controls,chr7,6048869,6048869,0.701005790917403,23,3258,3281
SRR25023039_1_val_1_bismark_bt2_pe.bismark.cov,controls,chr7,6048876,6048876,1.09655802619555,36,3247,3283
SRR25023039_1_val_1_bismark_bt2_pe.bismark.cov,controls,chr7,6048884,6048884,0.673400673400673,22,3245,3267
SRR25023039_1_val_1_bismark_bt2_pe.bismark.cov,controls,chr7,6048888,6048888,0.583717357910906,19,3236,3255
SRR25023039_1_val_1_bismark_bt2_pe.bismark.cov,controls,chr7,6048892,6048892,0.428396572827417,14,3254,3268
SRR25023039_1_val_1_bismark_bt2_pe.bismark.cov,controls,chr7,6048904,6048904,0.0,0,664,664
SRR25023039_1_val_1_bismark_bt2_pe.bismark.cov,controls,chr7,6048918,6048918,0.761962816214569,25,3256,3281
SRR25023039_1_val_1_bismark_bt2_pe.bismark.cov,controls,chr7,6048925,6048925,0.609942055504727,20,3259,3279
SRR25023039_1_val_1_bismark_bt2_pe.bismark.cov,controls,chr7,6048928,6048928,0.8838768668089,29,3252,3281
SRR25023039_1_val_1_bismark_bt2_pe.bismark.cov,controls,chr7,6048940,6048940,0.701861458651205,23,3254,3277
SRR25023039_1_val_1_bismark_bt2_pe.bismark.cov,controls,chr7,6048951,6048951,0.670527278268821,22,3259,3281
SRR25023039_1_val_1_bismark_bt2_pe.bismark.cov,controls,chr7,6048966,6048966,0.274473924977127,9,3270,3279
SRR25023039_1_val_1_bismark_bt2_pe.bismark.cov,controls,chr7,6048968,6048968,0.701219512195122,23,3257,3280
SRR25023039_1_val_1_bismark_bt2_pe.bismark.cov,controls,chr16,23652769,23652769,0.954198473282443,5,519,524
SRR25023039_1_val_1_bismark_bt2_pe.bismark.cov,controls,chr16,23652783,23652783,1.53550863723608,8,513,521
SRR25023039_1_val_1_bismark_bt2_pe.bismark.cov,controls,chr16,23652787,23652787,0.0,0,523,523
SRR25023039_1_val_1_bismark_bt2_pe.bismark.cov,controls,chr16,23652797,23652797,0.778210116731518,4,510,514
SRR25023039_1_val_1_bismark_bt2_pe.bismark.cov,controls,chr16,23652818,23652818,0.793650793650794,4,500,504
SRR25023039_1_val_1_bismark_bt2_pe.bismark.cov,controls,chr16,23652838,23652838,0.988142292490119,5,501,506
SRR25023039_1_val_1_bismark_bt2_pe.bismark.cov,controls,chr16,23652857,23652857,2.29445506692161,12,511,523
SRR25023039_1_val_1_bismark_bt2_pe.bismark.cov,controls,chr16,23652860,23652860,0.574712643678161,3,519,522
SRR25023039_1_val_1_bismark_bt2_pe.bismark.cov,controls,chr16,23652876,23652876,0.959692898272553,5,516,521
SRR25023039_1_val_1_bismark_bt2_pe.bismark.cov,controls,chr16,23652906,23652906,0.0,0,523,523
SRR25023039_1_val_1_bismark_bt2_pe.bismark.cov,controls,chr16,23652911,23652911,0.956022944550669,5,518,523
SRR25023039_1_val_1_bismark_bt2_pe.bismark.cov,controls,chr16,23652916,23652916,0.575815738963532,3,518,521
SRR25023039_1_val_1_bismark_bt2_pe.bismark.cov,controls,chr16,23652918,23652918,0.954198473282443,5,519,524
SRR25023039_1_val_1_bismark_bt2_pe.bismark.cov,controls,chr22,29137950,29137950,0.0,0,81,81
SRR25023039_1_val_1_bismark_bt2_pe.bismark.cov,controls,chr22,29137964,29137964,0.0,0,68,68
SRR25023039_1_val_1_bismark_bt2_pe.bismark.cov,controls,chr22,29137975,29137975,0.0,0,59,59
SRR25023039_1_val_1_bismark_bt2_pe.bismark.cov,controls,chr22,29137985,29137985,0.0,0,45,45
SRR25023039_1_val_1_bismark_bt2_pe.bismark.cov,controls,chr22,29137993,29137993,0.0,0,32,32
SRR25023039_1_val_1_bismark_bt2_pe.bismark.cov,controls,chr22,29138031,29138031,2.94117647058824,1,33,34
SRR25023039_1_val_1_bismark_bt2_pe.bismark.cov,controls,chr22,29138052,29138052,0.0,0,58,58
SRR25023039_1_val_1_bismark_bt2_pe.bismark.cov,controls,chr22,29138062,29138062,0.0,0,64,64
SRR25023039_1_val_1_bismark_bt2_pe.bismark.cov,controls,chr22,29138075,29138075,0.0,0,67,67
SRR25023039_1_val_1_bismark_bt2_pe.bismark.cov,controls,chr22,29138078,29138078,0.0,0,72,72
SRR25023039_1_val_1_bismark_bt2_pe.bismark.cov,controls,chr22,29138091,29138091,0.0,0,69,69
SRR25023039_1_val_1_bismark_bt2_pe.bismark.cov,controls,chr22,29138102,29138102,0.0,0,77,77
SRR25023039_1_val_1_bismark_bt2_pe.bismark.cov,controls,chr22,29138115,29138115,2.63157894736842,2,74,76
SRR25023039_1_val_1_bismark_bt2_pe.bismark.cov,controls,chr22,29138134,29138134,0.0,0,79,79
SRR25023039_1_val_1_bismark_bt2_pe.bismark.cov,controls,chr22,29138158,29138158,1.23456790123457,1,80,81
SRR25023039_1_val_1_bismark_bt2_pe.bismark.cov,controls,chr22,29138168,29138168,0.0,0,82,82
SRR25023039_1_val_1_bismark_bt2_pe.bismark.cov,controls,chr22,29138176,29138176,0.0,0,82,82
SRR25023039_1_val_1_bismark_bt2_pe.bismark.cov,controls,chr22,29138179,29138179,0.0,0,81,81
SRR25023039_1_val_1_bismark_bt2_pe.bismark.cov,controls,chr22,29138185,29138185,2.40963855421687,2,81,83
SRR25023039_1_val_1_bismark_bt2_pe.bismark.cov,controls,chr22,29138202,29138202,0.0,0,83,83
SRR25023039_1_val_1_bismark_bt2_pe.bismark.cov,controls,chr22,29138216,29138216,0.0,0,83,83
SRR25023039_1_val_1_bismark_bt2_pe.bismark.cov,controls,chr22,29138219,29138219,1.20481927710843,1,82,83
SRR25023039_1_val_1_bismark_bt2_pe.bismark.cov,controls,chr22,29138234,29138234,0.0,0,83,83
SRR25023039_1_val_1_bismark_bt2_pe.bismark.cov,controls,chr22,29138238,29138238,0.0,0,83,83
SRR25023040_1_val_1_bismark_bt2_pe.bismark.cov,controls,chr13,32889392,32889392,15.6728232189974,297,1598,1895
SRR25023040_1_val_1_bismark_bt2_pe.bismark.cov,controls,chr13,32889434,32889434,2.75132275132275,52,1838,1890
SRR25023040_1_val_1_bismark_bt2_pe.bismark.cov,controls,chr13,32889461,32889461,0.948366701791359,18,1880,1898
SRR25023040_1_val_1_bismark_bt2_pe.bismark.cov,controls,chr13,32889470,32889470,0.158562367864693,3,1889,1892
SRR25023040_1_val_1_bismark_bt2_pe.bismark.cov,controls,chr13,32889484,32889484,0.211528291909043,4,1887,1891
SRR25023040_1_val_1_bismark_bt2_pe.bismark.cov,controls,chr3,37034307,37034307,99.9551770506499,2230,1,2231
SRR25023040_1_val_1_bismark_bt2_pe.bismark.cov,controls,chr3,37034316,37034316,1.07768298158958,24,2203,2227
SRR25023040_1_val_1_bismark_bt2_pe.bismark.cov,controls,chr3,37034324,37034324,0.763701707097934,17,2209,2226
SRR25023040_1_val_1_bismark_bt2_pe.bismark.cov,controls,chr3,37034330,37034330,0.764388489208633,17,2207,2224
SRR25023040_1_val_1_bismark_bt2_pe.bismark.cov,controls,chr3,37034344,37034344,0.719101123595506,16,2209,2225
SRR25023040_1_val_1_bismark_bt2_pe.bismark.cov,controls,chr3,37034346,37034346,0.945520036019811,21,2200,2221
SRR25023040_1_val_1_bismark_bt2_pe.bismark.cov,controls,chr3,37034348,37034348,0.539083557951483,12,2214,2226
SRR25023040_1_val_1_bismark_bt2_pe.bismark.cov,controls,chr3,37034352,37034352,0.493938033228559,11,2216,2227
SRR25023040_1_val_1_bismark_bt2_pe.bismark.cov,controls,chr3,37034355,37034355,0.761990138951143,17,2214,2231
SRR25023040_1_val_1_bismark_bt2_pe.bismark.cov,controls,chr3,37034359,37034359,1.16696588868941,26,2202,2228
SRR25023040_1_val_1_bismark_bt2_pe.bismark.cov,controls,chr3,37034369,37034369,1.16696588868941,26,2202,2228
SRR25023040_1_val_1_bismark_bt2_pe.bismark.cov,controls,chr3,37034373,37034373,0.134770889487871,3,2223,2226
SRR25023040_1_val_1_bismark_bt2_pe.bismark.cov,controls,chr3,37034382,37034382,0.448430493273543,10,2220,2230
SRR25023040_1_val_1_bismark_bt2_pe.bismark.cov,controls,chr3,37034394,37034394,0.269179004037685,6,2223,2229
SRR25023040_1_val_1_bismark_bt2_pe.bismark.cov,controls,chr3,37034402,37034402,1.25786163522013,28,2198,2226
SRR25023040_1_val_1_bismark_bt2_pe.bismark.cov,controls,chr3,37034409,37034409,0.269058295964126,6,2224,2230
SRR25023040_1_val_1_bismark_bt2_pe.bismark.cov,controls,chr3,37034412,37034412,1.07719928186715,24,2204,2228
SRR25023040_1_val_1_bismark_bt2_pe.bismark.cov,controls,chr3,37034414,37034414,0.807537012113055,18,2211,2229
SRR25023040_1_val_1_bismark_bt2_pe.bismark.cov,controls,chr3,37034418,37034418,0.582959641255605,13,2217,2230
SRR25023040_1_val_1_bismark_bt2_pe.bismark.cov,controls,chr3,37034420,37034420,0.717488789237668,16,2214,2230
SRR25023040_1_val_1_bismark_bt2_pe.bismark.cov,controls,chr3,37034430,37034430,0.17961383026493,4,2223,2227
SRR25023040_1_val_1_bismark_bt2_pe.bismark.cov,controls,chr3,37034438,37034438,0.269420745397396,6,2221,2227
SRR25023040_1_val_1_bismark_bt2_pe.bismark.cov,controls,chr3,37034441,37034441,0.359227660529861,8,2219,2227
SRR25023040_1_val_1_bismark_bt2_pe.bismark.cov,controls,chr3,37034466,37034466,99.8654708520179,2227,3,2230
SRR25023040_1_val_1_bismark_bt2_pe.bismark.cov,controls,chr3,37034997,37034997,1.11160515784793,25,2224,2249
SRR25023040_1_val_1_bismark_bt2_pe.bismark.cov,controls,chr3,37035012,37035012,0.4014272970562,9,2233,2242
SRR25023040_1_val_1_bismark_bt2_pe.bismark.cov,controls,chr3,37035032,37035032,0.447828034034931,10,2223,2233
SRR25023040_1_val_1_bismark_bt2_pe.bismark.cov,controls,chr3,37035043,37035043,0.223114680946006,5,2236,2241
SRR25023040_1_val_1_bismark_bt2_pe.bismark.cov,controls,chr3,37035047,37035047,0.535714285714286,12,2228,2240
SRR25023040_1_val_1_bismark_bt2_pe.bismark.cov,controls,chr3,37035063,37035063,0.625279142474319,14,2225,2239
SRR25023040_1_val_1_bismark_bt2_pe.bismark.cov,controls,chr3,37035066,37035066,0.625838176128744,14,2223,2237
SRR25023040_1_val_1_bismark_bt2_pe.bismark.cov,controls,chr3,37035074,37035074,0.535953550692273,12,2227,2239
SRR25023040_1_val_1_bismark_bt2_pe.bismark.cov,controls,chr3,37035090,37035090,1.29579982126899,29,2209,2238
SRR25023040_1_val_1_bismark_bt2_pe.bismark.cov,controls,chr3,37035095,37035095,0.625,14,2226,2240
SRR25023040_1_val_1_bismark_bt2_pe.bismark.cov,controls,chr3,37035097,37035097,0.580616346583296,13,2226,2239
SRR25023040_1_val_1_bismark_bt2_pe.bismark.cov,controls,chr3,37035100,37035100,0.896057347670251,20,2212,2232
SRR25023040_1_val_1_bismark_bt2_pe.bismark.cov,controls,chr3,37035117,37035117,0.580616346583296,13,2226,2239
SRR25023040_1_val_1_bismark_bt2_pe.bismark.cov,controls,chr3,142297977,142297977,2.51256281407035,5,194,199
SRR25023040_1_val_1_bismark_bt2_pe.bismark.cov,controls,chr3,142298019,142298019,1.00502512562814,2,197,199
SRR25023040_1_val_1_bismark_bt2_pe.bismark.cov,controls,chr3,142298045,142298045,2.02020202020202,4,194,198
SRR25023040_1_val_1_bismark_bt2_pe.bismark.cov,controls,chr3,142298054,142298054,3.55329949238579,7,190,197
SRR25023040_1_val_1_bismark_bt2_pe.bismark.cov,controls,chr6,43543548,43543548,2.29885057471264,10,425,435
SRR25023040_1_val_1_bismark_bt2_pe.bismark.cov,controls,chr6,43543554,43543554,0.688073394495413,3,433,436
SRR25023040_1_val_1_bismark_bt2_pe.bismark.cov,controls,chr6,43543571,43543571,0.0,0,433,433
SRR25023040_1_val_1_bismark_bt2_pe.bismark.cov,controls,chr6,43543578,43543578,2.55813953488372,11,419,430
SRR25023040_1_val_1_bismark_bt2_pe.bismark.cov,controls,chr6,43543580,43543580,1.37614678899083,6,430,436
SRR25023040_1_val_1_bismark_bt2_pe.bismark.cov,controls,chr6,43543596,43543596,0.229357798165138,1,435,436
SRR25023040_1_val_1_bismark_bt2_pe.bismark.cov,controls,chr6,43543608,43543608,0.691244239631336,3,431,434
SRR25023040_1_val_1_bismark_bt2_pe.bismark.cov,controls,chr6,43543613,43543613,0.230414746543779,1,433,434
SRR25023040_1_val_1_bismark_bt2_pe.bismark.cov,controls,chr6,43543615,43543615,0.69284064665127,3,430,433
SRR25023040_1_val_1_bismark_bt2_pe.bismark.cov,controls,chr6,43543618,43543618,0.691244239631336,3,431,434
SRR25023040_1_val_1_bismark_bt2_pe.bismark.cov,controls,chr6,43543624,43543624,0.0,0,434,434
SRR25023040_1_val_1_bismark_bt2_pe.bismark.cov,controls,chr6,43543642,43543642,0.0,0,434,434
SRR25023040_1_val_1_bismark_bt2_pe.bismark.cov,controls,chr6,43543650,43543650,0.694444444444444,3,429,432
SRR25023040_1_val_1_bismark_bt2_pe.bismark.cov,controls,chr6,43543657,43543657,0.232558139534884,1,429,430
SRR25023040_1_val_1_bismark_bt2_pe.bismark.cov,controls,chr6,43543669,43543669,0.699300699300699,3,426,429
SRR25023040_1_val_1_bismark_bt2_pe.bismark.cov,controls,chr6,43543672,43543672,0.0,0,423,423
SRR25023040_1_val_1_bismark_bt2_pe.bismark.cov,controls,chr6,43543682,43543682,0.950118764845606,4,417,421
SRR25023040_1_val_1_bismark_bt2_pe.bismark.cov,controls,chr6,43543691,43543691,1.68269230769231,7,409,416
SRR25023040_1_val_1_bismark_bt2_pe.bismark.cov,controls,chr6,43543696,43543696,4.36893203883495,18,394,412
SRR25023040_1_val_1_bismark_bt2_pe.bismark.cov,controls,chr6,43543698,43543698,0.484261501210654,2,411,413
SRR25023040_1_val_1_bismark_bt2_pe.bismark.cov,controls,chr6,43543701,43543701,4.8661800486618,20,391,411
SRR25023040_1_val_1_bismark_bt2_pe.bismark.cov,controls,chr6,43543705,43543705,0.744416873449132,3,400,403
SRR25023040_1_val_1_bismark_bt2_pe.bismark.cov,controls,chr6,43543708,43543708,0.247524752475248,1,403,404
SRR25023040_1_val_1_bismark_bt2_pe.bismark.cov,controls,chr6,43543733,43543733,0.285714285714286,1,349,350
SRR25023040_1_val_1_bismark_bt2_pe.bismark.cov,controls,chr6,43543747,43543747,0.0,0,369,369
SRR25023040_1_val_1_bismark_bt2_pe.bismark.cov,controls,chr6,43543749,43543749,1.62162162162162,6,364,370
SRR25023040_1_val_1_bismark_bt2_pe.bismark.cov,controls,chr6,43543763,43543763,0.267379679144385,1,373,374
SRR25023040_1_val_1_bismark_bt2_pe.bismark.cov,controls,chr6,43543766,43543766,1.31926121372032,5,374,379
SRR25023040_1_val_1_bismark_bt2_pe.bismark.cov,controls,chr6,43543771,43543771,0.519480519480519,2,383,385
SRR25023040_1_val_1_bismark_bt2_pe.bismark.cov,controls,chr6,43543775,43543775,0.775193798449612,3,384,387
SRR25023040_1_val_1_bismark_bt2_pe.bismark.cov,controls,chr6,43543777,43543777,1.03092783505155,4,384,388
SRR25023040_1_val_1_bismark_bt2_pe.bismark.cov,controls,chr6,43543781,43543781,1.01781170483461,4,389,393
SRR25023040_1_val_1_bismark_bt2_pe.bismark.cov,controls,chr6,43543786,43543786,1.01781170483461,4,389,393
SRR25023040_1_val_1_bismark_bt2_pe.bismark.cov,controls,chr6,43543794,43543794,0.493827160493827,2,403,405
SRR25023040_1_val_1_bismark_bt2_pe.bismark.cov,controls,chr6,43543798,43543798,1.95121951219512,8,402,410
SRR25023040_1_val_1_bismark_bt2_pe.bismark.cov,controls,chr6,43543800,43543800,0.728155339805825,3,409,412
SRR25023040_1_val_1_bismark_bt2_pe.bismark.cov,controls,chr6,43543804,43543804,0.485436893203883,2,410,412
SRR25023040_1_val_1_bismark_bt2_pe.bismark.cov,controls,chr6,43543806,43543806,0.241545893719807,1,413,414
SRR25023040_1_val_1_bismark_bt2_pe.bismark.cov,controls,chr6,43543815,43543815,0.721153846153846,3,413,416
SRR25023040_1_val_1_bismark_bt2_pe.bismark.cov,controls,chr6,43543822,43543822,0.947867298578199,4,418,422
SRR25023040_1_val_1_bismark_bt2_pe.bismark.cov,controls,chr11,22647545,22647545,0.0,0,46,46
SRR25023040_1_val_1_bismark_bt2_pe.bismark.cov,controls,chr11,22647600,22647600,0.0,0,38,38
SRR25023040_1_val_1_bismark_bt2_pe.bismark.cov,controls,chr11,22647610,22647610,0.0,0,37,37
SRR25023040_1_val_1_bismark_bt2_pe.bismark.cov,controls,chr11,22647618,22647618,0.0,0,34,34
SRR25023040_1_val_1_bismark_bt2_pe.bismark.cov,controls,chr11,22647622,22647622,0.0,0,33,33
SRR25023040_1_val_1_bismark_bt2_pe.bismark.cov,controls,chr11,22647643,22647643,0.0,0,23,23
SRR25023040_1_val_1_bismark_bt2_pe.bismark.cov,controls,chr11,22647649,22647649,0.0,0,24,24
SRR25023040_1_val_1_bismark_bt2_pe.bismark.cov,controls,chr11,22647651,22647651,0.0,0,26,26
SRR25023040_1_val_1_bismark_bt2_pe.bismark.cov,controls,chr11,22647661,22647661,0.0,0,28,28
SRR25023040_1_val_1_bismark_bt2_pe.bismark.cov,controls,chr11,22647745,22647745,2.04081632653061,1,48,49
SRR25023040_1_val_1_bismark_bt2_pe.bismark.cov,controls,chr11,22647764,22647764,2.04081632653061,1,48,49
SRR25023040_1_val_1_bismark_bt2_pe.bismark.cov,controls,chr11,22647774,22647774,4.08163265306122,2,47,49
SRR25023040_1_val_1_bismark_bt2_pe.bismark.cov,controls,chr11,22647849,22647849,79.5918367346939,39,10,49
SRR25023040_1_val_1_bismark_bt2_pe.bismark.cov,controls,chr11,108093323,108093323,0.0,0,130,130
SRR25023040_1_val_1_bismark_bt2_pe.bismark.cov,controls,chr11,108093335,108093335,1.52671755725191,2,129,131
SRR25023040_1_val_1_bismark_bt2_pe.bismark.cov,controls,chr11,108093338,108093338,0.0,0,131,131
SRR25023040_1_val_1_bismark_bt2_pe.bismark.cov,controls,chr11,108093359,108093359,0.0,0,126,126
SRR25023040_1_val_1_bismark_bt2_pe.bismark.cov,controls,chr11,108093371,108093371,0.961538461538462,1,103,104
SRR25023040_1_val_1_bismark_bt2_pe.bismark.cov,controls,chr11,108093373,108093373,0.952380952380952,1,104,105
SRR25023040_1_val_1_bismark_bt2_pe.bismark.cov,controls,chr11,108093386,108093386,0.952380952380952,1,104,105
SRR25023040_1_val_1_bismark_bt2_pe.bismark.cov,controls,chr11,108093395,108093395,0.0,0,105,105
SRR25023040_1_val_1_bismark_bt2_pe.bismark.cov,controls,chr11,108093402,108093402,0.970873786407767,1,102,103
SRR25023040_1_val_1_bismark_bt2_pe.bismark.cov,controls,chr11,108093413,108093413,0.0,0,100,100
SRR25023040_1_val_1_bismark_bt2_pe.bismark.cov,controls,chr11,108093419,108093419,2.94117647058824,3,99,102
SRR25023040_1_val_1_bismark_bt2_pe.bismark.cov,controls,chr11,108093436,108093436,1.0,1,99,100
SRR25023040_1_val_1_bismark_bt2_pe.bismark.cov,controls,chr11,108093439,108093439,1.0,1,99,100
SRR25023040_1_val_1_bismark_bt2_pe.bismark.cov,controls,chr11,108093451,108093451,2.0,2,98,100
SRR25023040_1_val_1_bismark_bt2_pe.bismark.cov,controls,chr11,108093457,108093457,0.0,0,100,100
SRR25023040_1_val_1_bismark_bt2_pe.bismark.cov,controls,chr11,108093461,108093461,0.0,0,99,99
SRR25023040_1_val_1_bismark_bt2_pe.bismark.cov,controls,chr11,108093467,108093467,0.0,0,99,99
SRR25023040_1_val_1_bismark_bt2_pe.bismark.cov,controls,chr11,108093476,108093476,0.0,0,93,93
SRR25023040_1_val_1_bismark_bt2_pe.bismark.cov,controls,chr11,108093485,108093485,1.14942528735632,1,86,87
SRR25023040_1_val_1_bismark_bt2_pe.bismark.cov,controls,chr11,108093505,108093505,0.0,0,54,54
SRR25023040_1_val_1_bismark_bt2_pe.bismark.cov,controls,chr11,108093520,108093520,0.0,0,28,28
SRR25023040_1_val_1_bismark_bt2_pe.bismark.cov,controls,chr11,108093560,108093560,0.0,0,66,66
SRR25023040_1_val_1_bismark_bt2_pe.bismark.cov,controls,chr11,108093567,108093567,0.0,0,78,78
SRR25023040_1_val_1_bismark_bt2_pe.bismark.cov,controls,chr11,108093572,108093572,0.0,0,83,83
SRR25023040_1_val_1_bismark_bt2_pe.bismark.cov,controls,chr11,108093579,108093579,1.16279069767442,1,85,86
SRR25023040_1_val_1_bismark_bt2_pe.bismark.cov,controls,chr11,108093584,108093584,1.14942528735632,1,86,87
SRR25023040_1_val_1_bismark_bt2_pe.bismark.cov,controls,chr11,108093590,108093590,0.99009900990099,1,100,101
SRR25023040_1_val_1_bismark_bt2_pe.bismark.cov,controls,chr11,108093598,108093598,0.0,0,104,104
SRR25023040_1_val_1_bismark_bt2_pe.bismark.cov,controls,chr15,89786999,89786999,0.0,0,71,71
SRR25023040_1_val_1_bismark_bt2_pe.bismark.cov,controls,chr15,89787007,89787007,1.40845070422535,1,70,71
SRR25023040_1_val_1_bismark_bt2_pe.bismark.cov,controls,chr15,89787009,89787009,1.40845070422535,1,70,71
SRR25023040_1_val_1_bismark_bt2_pe.bismark.cov,controls,chr15,89787018,89787018,0.0,0,71,71
SRR25023040_1_val_1_bismark_bt2_pe.bismark.cov,controls,chr15,89787032,89787032,1.40845070422535,1,70,71
SRR25023040_1_val_1_bismark_bt2_pe.bismark.cov,controls,chr15,89787034,89787034,1.40845070422535,1,70,71
SRR25023040_1_val_1_bismark_bt2_pe.bismark.cov,controls,chr15,89787036,89787036,1.40845070422535,1,70,71
SRR25023040_1_val_1_bismark_bt2_pe.bismark.cov,controls,chr15,89787045,89787045,1.44927536231884,1,68,69
SRR25023040_1_val_1_bismark_bt2_pe.bismark.cov,controls,chr15,89787048,89787048,0.0,0,71,71
SRR25023040_1_val_1_bismark_bt2_pe.bismark.cov,controls,chr15,89787058,89787058,0.0,0,70,70
SRR25023040_1_val_1_bismark_bt2_pe.bismark.cov,controls,chr15,89787060,89787060,1.42857142857143,1,69,70
SRR25023040_1_val_1_bismark_bt2_pe.bismark.cov,controls,chr15,89787066,89787066,0.0,0,70,70
SRR25023040_1_val_1_bismark_bt2_pe.bismark.cov,controls,chr15,89787077,89787077,0.0,0,71,71
SRR25023040_1_val_1_bismark_bt2_pe.bismark.cov,controls,chr15,89787087,89787087,0.0,0,71,71
SRR25023040_1_val_1_bismark_bt2_pe.bismark.cov,controls,chr15,89787103,89787103,0.0,0,71,71
SRR25023040_1_val_1_bismark_bt2_pe.bismark.cov,controls,chr15,89787109,89787109,0.0,0,66,66
SRR25023040_1_val_1_bismark_bt2_pe.bismark.cov,controls,chr15,89787113,89787113,0.0,0,70,70
SRR25023040_1_val_1_bismark_bt2_pe.bismark.cov,controls,chr15,89787120,89787120,0.0,0,70,70
SRR25023040_1_val_1_bismark_bt2_pe.bismark.cov,controls,chr15,89787150,89787150,0.0,0,69,69
SRR25023040_1_val_1_bismark_bt2_pe.bismark.cov,controls,chr15,89787154,89787154,1.47058823529412,1,67,68
SRR25023040_1_val_1_bismark_bt2_pe.bismark.cov,controls,chr15,89787164,89787164,0.0,0,65,65
SRR25023040_1_val_1_bismark_bt2_pe.bismark.cov,controls,chr15,89787168,89787168,0.0,0,64,64
SRR25023040_1_val_1_bismark_bt2_pe.bismark.cov,controls,chr15,89787171,89787171,0.0,0,60,60
SRR25023040_1_val_1_bismark_bt2_pe.bismark.cov,controls,chr15,89787182,89787182,0.0,0,53,53
SRR25023040_1_val_1_bismark_bt2_pe.bismark.cov,controls,chr15,89787184,89787184,0.0,0,53,53
SRR25023040_1_val_1_bismark_bt2_pe.bismark.cov,controls,chr15,89787190,89787190,0.0,0,46,46
SRR25023040_1_val_1_bismark_bt2_pe.bismark.cov,controls,chr15,89787205,89787205,3.2258064516129,1,30,31
SRR25023040_1_val_1_bismark_bt2_pe.bismark.cov,controls,chr15,89787212,89787212,0.0,0,26,26
SRR25023040_1_val_1_bismark_bt2_pe.bismark.cov,controls,chr15,89787223,89787223,0.0,0,21,21
SRR25023040_1_val_1_bismark_bt2_pe.bismark.cov,controls,chr15,89787226,89787226,0.0,0,28,28
SRR25023040_1_val_1_bismark_bt2_pe.bismark.cov,controls,chr15,89787238,89787238,0.0,0,34,34
SRR25023040_1_val_1_bismark_bt2_pe.bismark.cov,controls,chr15,89787260,89787260,2.56410256410256,1,38,39
SRR25023040_1_val_1_bismark_bt2_pe.bismark.cov,controls,chr15,89787272,89787272,0.0,0,41,41
SRR25023040_1_val_1_bismark_bt2_pe.bismark.cov,controls,chr15,89787288,89787288,0.0,0,50,50
SRR25023040_1_val_1_bismark_bt2_pe.bismark.cov,controls,chr15,89787293,89787293,0.0,0,51,51
SRR25023040_1_val_1_bismark_bt2_pe.bismark.cov,controls,chr15,89787295,89787295,0.0,0,52,52
SRR25023040_1_val_1_bismark_bt2_pe.bismark.cov,controls,chr15,89787304,89787304,3.84615384615385,2,50,52
SRR25023040_1_val_1_bismark_bt2_pe.bismark.cov,controls,chr15,89787335,89787335,0.0,0,60,60
SRR25023040_1_val_1_bismark_bt2_pe.bismark.cov,controls,chr14,45604787,45604787,0.0,0,196,196
SRR25023040_1_val_1_bismark_bt2_pe.bismark.cov,controls,chr14,45604794,45604794,0.50761421319797,1,196,197
SRR25023040_1_val_1_bismark_bt2_pe.bismark.cov,controls,chr2,47596828,47596828,2.72177419354839,27,965,992
SRR25023040_1_val_1_bismark_bt2_pe.bismark.cov,controls,chr2,47596830,47596830,2.8169014084507,28,966,994
SRR25023040_1_val_1_bismark_bt2_pe.bismark.cov,controls,chr2,47596840,47596840,3.58923230309073,36,967,1003
SRR25023040_1_val_1_bismark_bt2_pe.bismark.cov,controls,chr2,47596849,47596849,20.2191235059761,203,801,1004
SRR25023040_1_val_1_bismark_bt2_pe.bismark.cov,controls,chr2,47596853,47596853,6.80680680680681,68,931,999
SRR25023040_1_val_1_bismark_bt2_pe.bismark.cov,controls,chr2,47596858,47596858,10.4,104,896,1000
SRR25023040_1_val_1_bismark_bt2_pe.bismark.cov,controls,chr2,47596862,47596862,7.51503006012024,75,923,998
SRR25023040_1_val_1_bismark_bt2_pe.bismark.cov,controls,chr2,47596869,47596869,24.5,245,755,1000
SRR25023040_1_val_1_bismark_bt2_pe.bismark.cov,controls,chr2,47596883,47596883,17.6352705410822,176,822,998
SRR25023040_1_val_1_bismark_bt2_pe.bismark.cov,controls,chr2,47596885,47596885,4.61847389558233,46,950,996
SRR25023040_1_val_1_bismark_bt2_pe.bismark.cov,controls,chr2,47596887,47596887,9.99000999000999,100,901,1001
SRR25023040_1_val_1_bismark_bt2_pe.bismark.cov,controls,chr2,47596897,47596897,5.81162324649299,58,940,998
SRR25023040_1_val_1_bismark_bt2_pe.bismark.cov,controls,chr2,47596900,47596900,4.91474423269809,49,948,997
SRR25023040_1_val_1_bismark_bt2_pe.bismark.cov,controls,chr2,47596907,47596907,2.71629778672032,27,967,994
SRR25023040_1_val_1_bismark_bt2_pe.bismark.cov,controls,chr2,47596912,47596912,3.91566265060241,39,957,996
SRR25023040_1_val_1_bismark_bt2_pe.bismark.cov,controls,chr2,47596930,47596930,7.31462925851703,73,925,998
SRR25023040_1_val_1_bismark_bt2_pe.bismark.cov,controls,chr2,47596942,47596942,7.73092369477912,77,919,996
SRR25023040_1_val_1_bismark_bt2_pe.bismark.cov,controls,chr2,47630224,47630224,0.639658848614073,3,466,469
SRR25023040_1_val_1_bismark_bt2_pe.bismark.cov,controls,chr2,47630227,47630227,0.214132762312634,1,466,467
SRR25023040_1_val_1_bismark_bt2_pe.bismark.cov,controls,chr2,47630233,47630233,1.30718954248366,6,453,459
SRR25023040_1_val_1_bismark_bt2_pe.bismark.cov,controls,chr2,47630237,47630237,1.06609808102345,5,464,469
SRR25023040_1_val_1_bismark_bt2_pe.bismark.cov,controls,chr2,47630240,47630240,1.06609808102345,5,464,469
SRR25023040_1_val_1_bismark_bt2_pe.bismark.cov,controls,chr2,47630244,47630244,1.49892933618844,7,460,467
SRR25023040_1_val_1_bismark_bt2_pe.bismark.cov,controls,chr2,47630251,47630251,0.641025641025641,3,465,468
SRR25023040_1_val_1_bismark_bt2_pe.bismark.cov,controls,chr2,47630265,47630265,0.213675213675214,1,467,468
SRR25023040_1_val_1_bismark_bt2_pe.bismark.cov,controls,chr2,47630292,47630292,0.426439232409382,2,467,469
SRR25023040_1_val_1_bismark_bt2_pe.bismark.cov,controls,chr2,47630294,47630294,0.426439232409382,2,467,469
SRR25023040_1_val_1_bismark_bt2_pe.bismark.cov,controls,chr2,58468506,58468506,0.636942675159236,1,156,157
SRR25023040_1_val_1_bismark_bt2_pe.bismark.cov,controls,chr2,58468513,58468513,2.56410256410256,4,152,156
SRR25023040_1_val_1_bismark_bt2_pe.bismark.cov,controls,chr2,58468519,58468519,2.61437908496732,4,149,153
SRR25023040_1_val_1_bismark_bt2_pe.bismark.cov,controls,chr2,58468523,58468523,0.649350649350649,1,153,154
SRR25023040_1_val_1_bismark_bt2_pe.bismark.cov,controls,chr2,58468527,58468527,0.0,0,155,155
SRR25023040_1_val_1_bismark_bt2_pe.bismark.cov,controls,chr2,58468530,58468530,0.0,0,155,155
SRR25023040_1_val_1_bismark_bt2_pe.bismark.cov,controls,chr2,58468532,58468532,0.0,0,154,154
SRR25023040_1_val_1_bismark_bt2_pe.bismark.cov,controls,chr2,58468537,58468537,0.649350649350649,1,153,154
SRR25023040_1_val_1_bismark_bt2_pe.bismark.cov,controls,chr2,58468555,58468555,1.34228187919463,2,147,149
SRR25023040_1_val_1_bismark_bt2_pe.bismark.cov,controls,chr2,58468576,58468576,0.0,0,145,145
SRR25023040_1_val_1_bismark_bt2_pe.bismark.cov,controls,chr2,58468578,58468578,0.704225352112676,1,141,142
SRR25023040_1_val_1_bismark_bt2_pe.bismark.cov,controls,chr2,58468582,58468582,0.0,0,142,142
SRR25023040_1_val_1_bismark_bt2_pe.bismark.cov,controls,chr2,58468599,58468599,0.769230769230769,1,129,130
SRR25023040_1_val_1_bismark_bt2_pe.bismark.cov,controls,chr2,58468618,58468618,0.0,0,89,89
SRR25023040_1_val_1_bismark_bt2_pe.bismark.cov,controls,chr2,58468625,58468625,0.0,0,88,88
SRR25023040_1_val_1_bismark_bt2_pe.bismark.cov,controls,chr2,58468632,58468632,0.0,0,87,87
SRR25023040_1_val_1_bismark_bt2_pe.bismark.cov,controls,chr2,58468652,58468652,0.769230769230769,1,129,130
SRR25023040_1_val_1_bismark_bt2_pe.bismark.cov,controls,chr2,58468737,58468737,0.613496932515337,1,162,163
SRR25023040_1_val_1_bismark_bt2_pe.bismark.cov,controls,chr2,58468823,58468823,0.613496932515337,1,162,163
SRR25023040_1_val_1_bismark_bt2_pe.bismark.cov,controls,chr2,128051674,128051674,0.0,0,66,66
SRR25023040_1_val_1_bismark_bt2_pe.bismark.cov,controls,chr2,128051690,128051690,0.0,0,239,239
SRR25023040_1_val_1_bismark_bt2_pe.bismark.cov,controls,chr2,128051704,128051704,0.4149377593361,1,240,241
SRR25023040_1_val_1_bismark_bt2_pe.bismark.cov,controls,chr2,128051707,128051707,0.416666666666667,1,239,240
SRR25023040_1_val_1_bismark_bt2_pe.bismark.cov,controls,chr2,128051709,128051709,0.826446280991736,2,240,242
SRR25023040_1_val_1_bismark_bt2_pe.bismark.cov,controls,chr2,128051716,128051716,1.25,3,237,240
SRR25023040_1_val_1_bismark_bt2_pe.bismark.cov,controls,chr2,128051733,128051733,0.826446280991736,2,240,242
SRR25023040_1_val_1_bismark_bt2_pe.bismark.cov,controls,chr2,128051743,128051743,1.2396694214876,3,239,242
SRR25023040_1_val_1_bismark_bt2_pe.bismark.cov,controls,chr10,89619506,89619506,98.5576923076923,205,3,208
SRR25023040_1_val_1_bismark_bt2_pe.bismark.cov,controls,chr10,89619510,89619510,97.5961538461538,203,5,208
SRR25023040_1_val_1_bismark_bt2_pe.bismark.cov,controls,chr10,89619512,89619512,98.5576923076923,205,3,208
SRR25023040_1_val_1_bismark_bt2_pe.bismark.cov,controls,chr10,89619522,89619522,98.0676328502416,203,4,207
SRR25023040_1_val_1_bismark_bt2_pe.bismark.cov,controls,chr10,89619550,89619550,98.5576923076923,205,3,208
SRR25023040_1_val_1_bismark_bt2_pe.bismark.cov,controls,chr10,89619555,89619555,98.0769230769231,204,4,208
SRR25023040_1_val_1_bismark_bt2_pe.bismark.cov,controls,chr10,89619566,89619566,91.3461538461538,190,18,208
SRR25023040_1_val_1_bismark_bt2_pe.bismark.cov,controls,chr10,89619580,89619580,94.7115384615385,197,11,208
SRR25023040_1_val_1_bismark_bt2_pe.bismark.cov,controls,chr17,41277106,41277106,0.0,0,284,284
SRR25023040_1_val_1_bismark_bt2_pe.bismark.cov,controls,chr17,41277115,41277115,0.701754385964912,2,283,285
SRR25023040_1_val_1_bismark_bt2_pe.bismark.cov,controls,chr17,41277117,41277117,0.704225352112676,2,282,284
SRR25023040_1_val_1_bismark_bt2_pe.bismark.cov,controls,chr17,41277153,41277153,0.0,0,284,284
SRR25023040_1_val_1_bismark_bt2_pe.bismark.cov,controls,chr17,41277160,41277160,0.0,0,286,286
SRR25023040_1_val_1_bismark_bt2_pe.bismark.cov,controls,chr17,41277174,41277174,1.05633802816901,3,281,284
SRR25023040_1_val_1_bismark_bt2_pe.bismark.cov,controls,chr17,41277214,41277214,0.344827586206897,1,289,290
SRR25023040_1_val_1_bismark_bt2_pe.bismark.cov,controls,chr17,41277232,41277232,1.04166666666667,3,285,288
SRR25023040_1_val_1_bismark_bt2_pe.bismark.cov,controls,chr17,56769746,56769746,82.6923076923077,43,9,52
SRR25023040_1_val_1_bismark_bt2_pe.bismark.cov,controls,chr17,56769760,56769760,86.5384615384615,45,7,52
SRR25023040_1_val_1_bismark_bt2_pe.bismark.cov,controls,chr17,56769767,56769767,69.2307692307692,36,16,52
SRR25023040_1_val_1_bismark_bt2_pe.bismark.cov,controls,chr17,56769830,56769830,1.72413793103448,1,57,58
SRR25023040_1_val_1_bismark_bt2_pe.bismark.cov,controls,chr17,56769866,56769866,1.72413793103448,1,57,58
SRR25023040_1_val_1_bismark_bt2_pe.bismark.cov,controls,chr17,56769883,56769883,1.72413793103448,1,57,58
SRR25023040_1_val_1_bismark_bt2_pe.bismark.cov,controls,chr17,56769891,56769891,0.0,0,57,57
SRR25023040_1_val_1_bismark_bt2_pe.bismark.cov,controls,chr17,56769895,56769895,0.0,0,57,57
SRR25023040_1_val_1_bismark_bt2_pe.bismark.cov,controls,chr17,56769904,56769904,3.7037037037037,2,52,54
SRR25023040_1_val_1_bismark_bt2_pe.bismark.cov,controls,chr17,56769912,56769912,0.0,0,55,55
SRR25023040_1_val_1_bismark_bt2_pe.bismark.cov,controls,chr17,56769922,56769922,3.92156862745098,2,49,51
SRR25023040_1_val_1_bismark_bt2_pe.bismark.cov,controls,chr17,56769929,56769929,0.0,0,44,44
SRR25023040_1_val_1_bismark_bt2_pe.bismark.cov,controls,chr17,56769936,56769936,0.0,0,44,44
SRR25023040_1_val_1_bismark_bt2_pe.bismark.cov,controls,chr17,56769941,56769941,0.0,0,36,36
SRR25023040_1_val_1_bismark_bt2_pe.bismark.cov,controls,chr17,56769944,56769944,0.0,0,33,33
SRR25023040_1_val_1_bismark_bt2_pe.bismark.cov,controls,chr17,56769948,56769948,0.0,0,28,28
SRR25023040_1_val_1_bismark_bt2_pe.bismark.cov,controls,chr17,56769956,56769956,0.0,0,23,23
SRR25023040_1_val_1_bismark_bt2_pe.bismark.cov,controls,chr17,56769982,56769982,0.0,0,36,36
SRR25023040_1_val_1_bismark_bt2_pe.bismark.cov,controls,chr17,56770003,56770003,0.0,0,47,47
SRR25023040_1_val_1_bismark_bt2_pe.bismark.cov,controls,chr17,56770008,56770008,0.0,0,49,49
SRR25023040_1_val_1_bismark_bt2_pe.bismark.cov,controls,chr17,56770010,56770010,0.0,0,50,50
SRR25023040_1_val_1_bismark_bt2_pe.bismark.cov,controls,chr17,56770018,56770018,0.0,0,52,52
SRR25023040_1_val_1_bismark_bt2_pe.bismark.cov,controls,chr17,56770023,56770023,0.0,0,52,52
SRR25023040_1_val_1_bismark_bt2_pe.bismark.cov,controls,chr17,56770038,56770038,0.0,0,53,53
SRR25023040_1_val_1_bismark_bt2_pe.bismark.cov,controls,chr17,56770057,56770057,5.45454545454545,3,52,55
SRR25023040_1_val_1_bismark_bt2_pe.bismark.cov,controls,chr17,56770069,56770069,0.0,0,56,56
SRR25023040_1_val_1_bismark_bt2_pe.bismark.cov,controls,chr17,56770074,56770074,0.0,0,56,56
SRR25023040_1_val_1_bismark_bt2_pe.bismark.cov,controls,chr17,56770093,56770093,0.0,0,57,57
SRR25023040_1_val_1_bismark_bt2_pe.bismark.cov,controls,chr17,59940970,59940970,0.54678007290401,9,1637,1646
SRR25023040_1_val_1_bismark_bt2_pe.bismark.cov,controls,chr17,59940975,59940975,0.548112058465286,9,1633,1642
SRR25023040_1_val_1_bismark_bt2_pe.bismark.cov,controls,chr17,59940988,59940988,0.372208436724566,6,1606,1612
SRR25023040_1_val_1_bismark_bt2_pe.bismark.cov,controls,chr17,59940997,59940997,0.554400554400554,8,1435,1443
SRR25023040_1_val_1_bismark_bt2_pe.bismark.cov,controls,chr17,59941017,59941017,0.230237912509593,3,1300,1303
SRR25023040_1_val_1_bismark_bt2_pe.bismark.cov,controls,chr17,59941051,59941051,0.866666666666667,13,1487,1500
SRR25023040_1_val_1_bismark_bt2_pe.bismark.cov,controls,chr17,59941053,59941053,1.10361741263029,18,1613,1631
SRR25023040_1_val_1_bismark_bt2_pe.bismark.cov,controls,chr17,59941056,59941056,1.71277997364954,26,1492,1518
SRR25023040_1_val_1_bismark_bt2_pe.bismark.cov,controls,chr17,59941067,59941067,0.260586319218241,4,1531,1535
SRR25023040_1_val_1_bismark_bt2_pe.bismark.cov,controls,chr17,59941110,59941110,0.288850375505488,5,1726,1731
SRR25023040_1_val_1_bismark_bt2_pe.bismark.cov,controls,chr17,59941133,59941133,0.749711649365629,13,1721,1734
SRR25023040_1_val_1_bismark_bt2_pe.bismark.cov,controls,chr17,59941136,59941136,0.576368876080692,10,1725,1735
SRR25023040_1_val_1_bismark_bt2_pe.bismark.cov,controls,chr17,59941187,59941187,0.457927876359473,8,1739,1747
SRR25023040_1_val_1_bismark_bt2_pe.bismark.cov,controls,chr17,59941191,59941191,0.742009132420091,13,1739,1752
SRR25023040_1_val_1_bismark_bt2_pe.bismark.cov,controls,chr17,59941201,59941201,0.589101620029455,8,1350,1358
SRR25023040_1_val_1_bismark_bt2_pe.bismark.cov,controls,chr17,59941202,59941202,1.2012012012012,4,329,333
SRR25023040_1_val_1_bismark_bt2_pe.bismark.cov,controls,chr7,6048869,6048869,0.322450624748085,8,2473,2481
SRR25023040_1_val_1_bismark_bt2_pe.bismark.cov,controls,chr7,6048876,6048876,0.888171174808236,22,2455,2477
SRR25023040_1_val_1_bismark_bt2_pe.bismark.cov,controls,chr7,6048884,6048884,0.686868686868687,17,2458,2475
SRR25023040_1_val_1_bismark_bt2_pe.bismark.cov,controls,chr7,6048888,6048888,0.569337128914193,14,2445,2459
SRR25023040_1_val_1_bismark_bt2_pe.bismark.cov,controls,chr7,6048892,6048892,0.526742301458671,13,2455,2468
SRR25023040_1_val_1_bismark_bt2_pe.bismark.cov,controls,chr7,6048904,6048904,0.0,0,468,468
SRR25023040_1_val_1_bismark_bt2_pe.bismark.cov,controls,chr7,6048918,6048918,1.00969305331179,25,2451,2476
SRR25023040_1_val_1_bismark_bt2_pe.bismark.cov,controls,chr7,6048925,6048925,0.728744939271255,18,2452,2470
SRR25023040_1_val_1_bismark_bt2_pe.bismark.cov,controls,chr7,6048928,6048928,0.444803881924788,11,2462,2473
SRR25023040_1_val_1_bismark_bt2_pe.bismark.cov,controls,chr7,6048940,6048940,0.807754442649435,20,2456,2476
SRR25023040_1_val_1_bismark_bt2_pe.bismark.cov,controls,chr7,6048951,6048951,0.282828282828283,7,2468,2475
SRR25023040_1_val_1_bismark_bt2_pe.bismark.cov,controls,chr7,6048966,6048966,0.968132311415893,24,2455,2479
SRR25023040_1_val_1_bismark_bt2_pe.bismark.cov,controls,chr7,6048968,6048968,0.485436893203883,12,2460,2472
SRR25023040_1_val_1_bismark_bt2_pe.bismark.cov,controls,chr16,23652769,23652769,0.671140939597315,2,296,298
SRR25023040_1_val_1_bismark_bt2_pe.bismark.cov,controls,chr16,23652783,23652783,1.01010101010101,3,294,297
SRR25023040_1_val_1_bismark_bt2_pe.bismark.cov,controls,chr16,23652787,23652787,0.338983050847458,1,294,295
SRR25023040_1_val_1_bismark_bt2_pe.bismark.cov,controls,chr16,23652797,23652797,0.684931506849315,2,290,292
SRR25023040_1_val_1_bismark_bt2_pe.bismark.cov,controls,chr16,23652818,23652818,0.0,0,286,286
SRR25023040_1_val_1_bismark_bt2_pe.bismark.cov,controls,chr16,23652838,23652838,1.02389078498294,3,290,293
SRR25023040_1_val_1_bismark_bt2_pe.bismark.cov,controls,chr16,23652857,23652857,0.0,0,300,300
SRR25023040_1_val_1_bismark_bt2_pe.bismark.cov,controls,chr16,23652860,23652860,0.664451827242525,2,299,301
SRR25023040_1_val_1_bismark_bt2_pe.bismark.cov,controls,chr16,23652876,23652876,1.66666666666667,5,295,300
SRR25023040_1_val_1_bismark_bt2_pe.bismark.cov,controls,chr16,23652906,23652906,0.662251655629139,2,300,302
SRR25023040_1_val_1_bismark_bt2_pe.bismark.cov,controls,chr16,23652911,23652911,0.0,0,302,302
SRR25023040_1_val_1_bismark_bt2_pe.bismark.cov,controls,chr16,23652916,23652916,0.666666666666667,2,298,300
SRR25023040_1_val_1_bismark_bt2_pe.bismark.cov,controls,chr16,23652918,23652918,0.99009900990099,3,300,303
SRR25023040_1_val_1_bismark_bt2_pe.bismark.cov,controls,chr22,29137950,29137950,0.0,0,82,82
SRR25023040_1_val_1_bismark_bt2_pe.bismark.cov,controls,chr22,29137964,29137964,0.0,0,74,74
SRR25023040_1_val_1_bismark_bt2_pe.bismark.cov,controls,chr22,29137975,29137975,0.0,0,64,64
SRR25023040_1_val_1_bismark_bt2_pe.bismark.cov,controls,chr22,29137985,29137985,0.0,0,42,42
SRR25023040_1_val_1_bismark_bt2_pe.bismark.cov,controls,chr22,29137993,29137993,0.0,0,29,29
SRR25023040_1_val_1_bismark_bt2_pe.bismark.cov,controls,chr22,29138031,29138031,0.0,0,38,38
SRR25023040_1_val_1_bismark_bt2_pe.bismark.cov,controls,chr22,29138052,29138052,0.0,0,56,56
SRR25023040_1_val_1_bismark_bt2_pe.bismark.cov,controls,chr22,29138062,29138062,0.0,0,59,59
SRR25023040_1_val_1_bismark_bt2_pe.bismark.cov,controls,chr22,29138075,29138075,0.0,0,66,66
SRR25023040_1_val_1_bismark_bt2_pe.bismark.cov,controls,chr22,29138078,29138078,0.0,0,71,71
SRR25023040_1_val_1_bismark_bt2_pe.bismark.cov,controls,chr22,29138091,29138091,1.47058823529412,1,67,68
SRR25023040_1_val_1_bismark_bt2_pe.bismark.cov,controls,chr22,29138102,29138102,1.23456790123457,1,80,81
SRR25023040_1_val_1_bismark_bt2_pe.bismark.cov,controls,chr22,29138115,29138115,1.20481927710843,1,82,83
SRR25023040_1_val_1_bismark_bt2_pe.bismark.cov,controls,chr22,29138134,29138134,0.0,0,85,85
SRR25023040_1_val_1_bismark_bt2_pe.bismark.cov,controls,chr22,29138158,29138158,0.0,0,86,86
SRR25023040_1_val_1_bismark_bt2_pe.bismark.cov,controls,chr22,29138168,29138168,0.0,0,87,87
SRR25023040_1_val_1_bismark_bt2_pe.bismark.cov,controls,chr22,29138176,29138176,0.0,0,87,87
SRR25023040_1_val_1_bismark_bt2_pe.bismark.cov,controls,chr22,29138179,29138179,0.0,0,86,86
SRR25023040_1_val_1_bismark_bt2_pe.bismark.cov,controls,chr22,29138185,29138185,1.14942528735632,1,86,87
SRR25023040_1_val_1_bismark_bt2_pe.bismark.cov,controls,chr22,29138202,29138202,2.27272727272727,2,86,88
SRR25023040_1_val_1_bismark_bt2_pe.bismark.cov,controls,chr22,29138216,29138216,0.0,0,87,87
SRR25023040_1_val_1_bismark_bt2_pe.bismark.cov,controls,chr22,29138219,29138219,0.0,0,87,87
SRR25023040_1_val_1_bismark_bt2_pe.bismark.cov,controls,chr22,29138234,29138234,0.0,0,88,88
SRR25023040_1_val_1_bismark_bt2_pe.bismark.cov,controls,chr22,29138238,29138238,1.17647058823529,1,84,85
SRR25023041_1_val_1_bismark_bt2_pe.bismark.cov,controls,chr3,37034307,37034307,99.9428897772701,1750,1,1751
SRR25023041_1_val_1_bismark_bt2_pe.bismark.cov,controls,chr3,37034316,37034316,0.68886337543054,12,1730,1742
SRR25023041_1_val_1_bismark_bt2_pe.bismark.cov,controls,chr3,37034324,37034324,0.573065902578797,10,1735,1745
SRR25023041_1_val_1_bismark_bt2_pe.bismark.cov,controls,chr3,37034330,37034330,0.114744693057946,2,1741,1743
SRR25023041_1_val_1_bismark_bt2_pe.bismark.cov,controls,chr3,37034344,37034344,1.2075905692927,21,1718,1739
SRR25023041_1_val_1_bismark_bt2_pe.bismark.cov,controls,chr3,37034346,37034346,0.402067777139575,7,1734,1741
SRR25023041_1_val_1_bismark_bt2_pe.bismark.cov,controls,chr3,37034348,37034348,0.516351118760757,9,1734,1743
SRR25023041_1_val_1_bismark_bt2_pe.bismark.cov,controls,chr3,37034352,37034352,0.690448791714614,12,1726,1738
SRR25023041_1_val_1_bismark_bt2_pe.bismark.cov,controls,chr3,37034355,37034355,0.516647531572905,9,1733,1742
SRR25023041_1_val_1_bismark_bt2_pe.bismark.cov,controls,chr3,37034359,37034359,1.20481927710843,21,1722,1743
SRR25023041_1_val_1_bismark_bt2_pe.bismark.cov,controls,chr3,37034369,37034369,1.32107983917289,23,1718,1741
SRR25023041_1_val_1_bismark_bt2_pe.bismark.cov,controls,chr3,37034373,37034373,0.575373993095512,10,1728,1738
SRR25023041_1_val_1_bismark_bt2_pe.bismark.cov,controls,chr3,37034382,37034382,0.401606425702811,7,1736,1743
SRR25023041_1_val_1_bismark_bt2_pe.bismark.cov,controls,chr3,37034394,37034394,0.574052812858783,10,1732,1742
SRR25023041_1_val_1_bismark_bt2_pe.bismark.cov,controls,chr3,37034402,37034402,0.402761795166859,7,1731,1738
SRR25023041_1_val_1_bismark_bt2_pe.bismark.cov,controls,chr3,37034409,37034409,0.34443168771527,6,1736,1742
SRR25023041_1_val_1_bismark_bt2_pe.bismark.cov,controls,chr3,37034412,37034412,0.459506031016657,8,1733,1741
SRR25023041_1_val_1_bismark_bt2_pe.bismark.cov,controls,chr3,37034414,37034414,0.574712643678161,10,1730,1740
SRR25023041_1_val_1_bismark_bt2_pe.bismark.cov,controls,chr3,37034418,37034418,0.805060379528465,14,1725,1739
SRR25023041_1_val_1_bismark_bt2_pe.bismark.cov,controls,chr3,37034420,37034420,0.517538815411156,9,1730,1739
SRR25023041_1_val_1_bismark_bt2_pe.bismark.cov,controls,chr3,37034430,37034430,0.517241379310345,9,1731,1740
SRR25023041_1_val_1_bismark_bt2_pe.bismark.cov,controls,chr3,37034438,37034438,0.688073394495413,12,1732,1744
SRR25023041_1_val_1_bismark_bt2_pe.bismark.cov,controls,chr3,37034441,37034441,0.286861732644865,5,1738,1743
SRR25023041_1_val_1_bismark_bt2_pe.bismark.cov,controls,chr3,37034466,37034466,100.0,1746,0,1746
SRR25023041_1_val_1_bismark_bt2_pe.bismark.cov,controls,chr3,37034997,37034997,0.39344262295082,6,1519,1525
SRR25023041_1_val_1_bismark_bt2_pe.bismark.cov,controls,chr3,37035012,37035012,0.328083989501312,5,1519,1524
SRR25023041_1_val_1_bismark_bt2_pe.bismark.cov,controls,chr3,37035032,37035032,0.922874093605801,14,1503,1517
SRR25023041_1_val_1_bismark_bt2_pe.bismark.cov,controls,chr3,37035043,37035043,0.591715976331361,9,1512,1521
SRR25023041_1_val_1_bismark_bt2_pe.bismark.cov,controls,chr3,37035047,37035047,0.329380764163373,5,1513,1518
SRR25023041_1_val_1_bismark_bt2_pe.bismark.cov,controls,chr3,37035063,37035063,0.526662277814351,8,1511,1519
SRR25023041_1_val_1_bismark_bt2_pe.bismark.cov,controls,chr3,37035066,37035066,0.197628458498024,3,1515,1518
SRR25023041_1_val_1_bismark_bt2_pe.bismark.cov,controls,chr3,37035074,37035074,0.328731097961867,5,1516,1521
SRR25023041_1_val_1_bismark_bt2_pe.bismark.cov,controls,chr3,37035090,37035090,0.919842312746386,14,1508,1522
SRR25023041_1_val_1_bismark_bt2_pe.bismark.cov,controls,chr3,37035095,37035095,1.05193951347797,16,1505,1521
SRR25023041_1_val_1_bismark_bt2_pe.bismark.cov,controls,chr3,37035097,37035097,0.196850393700787,3,1521,1524
SRR25023041_1_val_1_bismark_bt2_pe.bismark.cov,controls,chr3,37035100,37035100,0.589777195281782,9,1517,1526
SRR25023041_1_val_1_bismark_bt2_pe.bismark.cov,controls,chr3,37035117,37035117,0.984251968503937,15,1509,1524
SRR25023041_1_val_1_bismark_bt2_pe.bismark.cov,controls,chr3,142297977,142297977,1.86335403726708,3,158,161
SRR25023041_1_val_1_bismark_bt2_pe.bismark.cov,controls,chr3,142298019,142298019,0.0,0,161,161
SRR25023041_1_val_1_bismark_bt2_pe.bismark.cov,controls,chr3,142298045,142298045,1.86335403726708,3,158,161
SRR25023041_1_val_1_bismark_bt2_pe.bismark.cov,controls,chr3,142298054,142298054,1.875,3,157,160
SRR25023041_1_val_1_bismark_bt2_pe.bismark.cov,controls,chr17,41277106,41277106,1.86046511627907,4,211,215
SRR25023041_1_val_1_bismark_bt2_pe.bismark.cov,controls,chr17,41277115,41277115,1.4018691588785,3,211,214
SRR25023041_1_val_1_bismark_bt2_pe.bismark.cov,controls,chr17,41277117,41277117,1.86915887850467,4,210,214
SRR25023041_1_val_1_bismark_bt2_pe.bismark.cov,controls,chr17,41277153,41277153,0.0,0,217,217
SRR25023041_1_val_1_bismark_bt2_pe.bismark.cov,controls,chr17,41277160,41277160,0.460829493087558,1,216,217
SRR25023041_1_val_1_bismark_bt2_pe.bismark.cov,controls,chr17,41277174,41277174,0.925925925925926,2,214,216
SRR25023041_1_val_1_bismark_bt2_pe.bismark.cov,controls,chr17,41277187,41277187,4.14746543778802,9,208,217
SRR25023041_1_val_1_bismark_bt2_pe.bismark.cov,controls,chr17,41277214,41277214,0.0,0,217,217
SRR25023041_1_val_1_bismark_bt2_pe.bismark.cov,controls,chr17,41277232,41277232,1.38248847926267,3,214,217
SRR25023041_1_val_1_bismark_bt2_pe.bismark.cov,controls,chr17,56769746,56769746,83.3333333333333,45,9,54
SRR25023041_1_val_1_bismark_bt2_pe.bismark.cov,controls,chr17,56769760,56769760,84.9056603773585,45,8,53
SRR25023041_1_val_1_bismark_bt2_pe.bismark.cov,controls,chr17,56769767,56769767,77.3584905660377,41,12,53
SRR25023041_1_val_1_bismark_bt2_pe.bismark.cov,controls,chr17,56769830,56769830,0.0,0,51,51
SRR25023041_1_val_1_bismark_bt2_pe.bismark.cov,controls,chr17,56769866,56769866,0.0,0,51,51
SRR25023041_1_val_1_bismark_bt2_pe.bismark.cov,controls,chr17,56769883,56769883,0.0,0,51,51
SRR25023041_1_val_1_bismark_bt2_pe.bismark.cov,controls,chr17,56769891,56769891,2.0,1,49,50
SRR25023041_1_val_1_bismark_bt2_pe.bismark.cov,controls,chr17,56769895,56769895,2.0,1,49,50
SRR25023041_1_val_1_bismark_bt2_pe.bismark.cov,controls,chr17,56769904,56769904,2.08333333333333,1,47,48
SRR25023041_1_val_1_bismark_bt2_pe.bismark.cov,controls,chr17,56769912,56769912,0.0,0,48,48
SRR25023041_1_val_1_bismark_bt2_pe.bismark.cov,controls,chr17,56769922,56769922,0.0,0,43,43
SRR25023041_1_val_1_bismark_bt2_pe.bismark.cov,controls,chr17,56769929,56769929,0.0,0,37,37
SRR25023041_1_val_1_bismark_bt2_pe.bismark.cov,controls,chr17,56769936,56769936,0.0,0,33,33
SRR25023041_1_val_1_bismark_bt2_pe.bismark.cov,controls,chr17,56769941,56769941,0.0,0,26,26
SRR25023041_1_val_1_bismark_bt2_pe.bismark.cov,controls,chr17,56769944,56769944,0.0,0,24,24
SRR25023041_1_val_1_bismark_bt2_pe.bismark.cov,controls,chr17,56769948,56769948,0.0,0,21,21
SRR25023041_1_val_1_bismark_bt2_pe.bismark.cov,controls,chr17,56769982,56769982,0.0,0,25,25
SRR25023041_1_val_1_bismark_bt2_pe.bismark.cov,controls,chr17,56770003,56770003,0.0,0,42,42
SRR25023041_1_val_1_bismark_bt2_pe.bismark.cov,controls,chr17,56770008,56770008,0.0,0,42,42
SRR25023041_1_val_1_bismark_bt2_pe.bismark.cov,controls,chr17,56770010,56770010,0.0,0,44,44
SRR25023041_1_val_1_bismark_bt2_pe.bismark.cov,controls,chr17,56770018,56770018,0.0,0,45,45
SRR25023041_1_val_1_bismark_bt2_pe.bismark.cov,controls,chr17,56770023,56770023,0.0,0,46,46
SRR25023041_1_val_1_bismark_bt2_pe.bismark.cov,controls,chr17,56770038,56770038,0.0,0,48,48
SRR25023041_1_val_1_bismark_bt2_pe.bismark.cov,controls,chr17,56770057,56770057,4.08163265306122,2,47,49
SRR25023041_1_val_1_bismark_bt2_pe.bismark.cov,controls,chr17,56770069,56770069,0.0,0,49,49
SRR25023041_1_val_1_bismark_bt2_pe.bismark.cov,controls,chr17,56770074,56770074,0.0,0,49,49
SRR25023041_1_val_1_bismark_bt2_pe.bismark.cov,controls,chr17,56770093,56770093,0.0,0,51,51
SRR25023041_1_val_1_bismark_bt2_pe.bismark.cov,controls,chr17,59940970,59940970,0.542822677925211,9,1649,1658
SRR25023041_1_val_1_bismark_bt2_pe.bismark.cov,controls,chr17,59940975,59940975,0.721153846153846,12,1652,1664
SRR25023041_1_val_1_bismark_bt2_pe.bismark.cov,controls,chr17,59940988,59940988,0.731707317073171,12,1628,1640
SRR25023041_1_val_1_bismark_bt2_pe.bismark.cov,controls,chr17,59940997,59940997,0.611413043478261,9,1463,1472
SRR25023041_1_val_1_bismark_bt2_pe.bismark.cov,controls,chr17,59941017,59941017,0.626118067978533,7,1111,1118
SRR25023041_1_val_1_bismark_bt2_pe.bismark.cov,controls,chr17,59941051,59941051,0.264550264550265,4,1508,1512
SRR25023041_1_val_1_bismark_bt2_pe.bismark.cov,controls,chr17,59941053,59941053,0.860479409956976,14,1613,1627
SRR25023041_1_val_1_bismark_bt2_pe.bismark.cov,controls,chr17,59941056,59941056,0.582147477360931,9,1537,1546
SRR25023041_1_val_1_bismark_bt2_pe.bismark.cov,controls,chr17,59941067,59941067,0.387346675274371,6,1543,1549
SRR25023041_1_val_1_bismark_bt2_pe.bismark.cov,controls,chr17,59941110,59941110,0.351288056206089,6,1702,1708
SRR25023041_1_val_1_bismark_bt2_pe.bismark.cov,controls,chr17,59941133,59941133,0.291885580852306,5,1708,1713
SRR25023041_1_val_1_bismark_bt2_pe.bismark.cov,controls,chr17,59941136,59941136,0.642523364485981,11,1701,1712
SRR25023041_1_val_1_bismark_bt2_pe.bismark.cov,controls,chr17,59941187,59941187,0.349243306169965,6,1712,1718
SRR25023041_1_val_1_bismark_bt2_pe.bismark.cov,controls,chr17,59941191,59941191,0.58173356602676,10,1709,1719
SRR25023041_1_val_1_bismark_bt2_pe.bismark.cov,controls,chr17,59941201,59941201,0.878594249201278,11,1241,1252
SRR25023041_1_val_1_bismark_bt2_pe.bismark.cov,controls,chr17,59941202,59941202,0.252525252525253,1,395,396
SRR25023041_1_val_1_bismark_bt2_pe.bismark.cov,controls,chr13,32889392,32889392,22.9508196721311,420,1410,1830
SRR25023041_1_val_1_bismark_bt2_pe.bismark.cov,controls,chr13,32889434,32889434,5.53121577217963,101,1725,1826
SRR25023041_1_val_1_bismark_bt2_pe.bismark.cov,controls,chr13,32889461,32889461,0.87719298245614,16,1808,1824
SRR25023041_1_val_1_bismark_bt2_pe.bismark.cov,controls,chr13,32889470,32889470,0.986842105263158,18,1806,1824
SRR25023041_1_val_1_bismark_bt2_pe.bismark.cov,controls,chr13,32889484,32889484,0.491266375545852,9,1823,1832
SRR25023041_1_val_1_bismark_bt2_pe.bismark.cov,controls,chr2,47596828,47596828,1.03448275862069,6,574,580
SRR25023041_1_val_1_bismark_bt2_pe.bismark.cov,controls,chr2,47596830,47596830,1.55172413793103,9,571,580
SRR25023041_1_val_1_bismark_bt2_pe.bismark.cov,controls,chr2,47596840,47596840,1.19047619047619,7,581,588
SRR25023041_1_val_1_bismark_bt2_pe.bismark.cov,controls,chr2,47596849,47596849,6.6213921901528,39,550,589
SRR25023041_1_val_1_bismark_bt2_pe.bismark.cov,controls,chr2,47596858,47596858,4.07470288624788,24,565,589
SRR25023041_1_val_1_bismark_bt2_pe.bismark.cov,controls,chr2,47596862,47596862,3.2312925170068,19,569,588
SRR25023041_1_val_1_bismark_bt2_pe.bismark.cov,controls,chr2,47596869,47596869,3.90492359932088,23,566,589
SRR25023041_1_val_1_bismark_bt2_pe.bismark.cov,controls,chr2,47596883,47596883,4.26621160409556,25,561,586
SRR25023041_1_val_1_bismark_bt2_pe.bismark.cov,controls,chr2,47596885,47596885,1.01867572156197,6,583,589
SRR25023041_1_val_1_bismark_bt2_pe.bismark.cov,controls,chr2,47596887,47596887,4.24448217317487,25,564,589
SRR25023041_1_val_1_bismark_bt2_pe.bismark.cov,controls,chr2,47596897,47596897,2.03389830508475,12,578,590
SRR25023041_1_val_1_bismark_bt2_pe.bismark.cov,controls,chr2,47596900,47596900,2.20713073005093,13,576,589
SRR25023041_1_val_1_bismark_bt2_pe.bismark.cov,controls,chr2,47596907,47596907,2.38095238095238,14,574,588
SRR25023041_1_val_1_bismark_bt2_pe.bismark.cov,controls,chr2,47596912,47596912,1.53061224489796,9,579,588
SRR25023041_1_val_1_bismark_bt2_pe.bismark.cov,controls,chr2,47596930,47596930,2.54668930390492,15,574,589
SRR25023041_1_val_1_bismark_bt2_pe.bismark.cov,controls,chr2,47596942,47596942,3.05084745762712,18,572,590
SRR25023041_1_val_1_bismark_bt2_pe.bismark.cov,controls,chr2,47630224,47630224,0.821917808219178,3,362,365
SRR25023041_1_val_1_bismark_bt2_pe.bismark.cov,controls,chr2,47630227,47630227,1.0989010989011,4,360,364
SRR25023041_1_val_1_bismark_bt2_pe.bismark.cov,controls,chr2,47630233,47630233,1.11111111111111,4,356,360
SRR25023041_1_val_1_bismark_bt2_pe.bismark.cov,controls,chr2,47630237,47630237,0.549450549450549,2,362,364
SRR25023041_1_val_1_bismark_bt2_pe.bismark.cov,controls,chr2,47630240,47630240,0.0,0,363,363
SRR25023041_1_val_1_bismark_bt2_pe.bismark.cov,controls,chr2,47630244,47630244,1.66666666666667,6,354,360
SRR25023041_1_val_1_bismark_bt2_pe.bismark.cov,controls,chr2,47630251,47630251,0.550964187327824,2,361,363
SRR25023041_1_val_1_bismark_bt2_pe.bismark.cov,controls,chr2,47630265,47630265,0.0,0,362,362
SRR25023041_1_val_1_bismark_bt2_pe.bismark.cov,controls,chr2,47630292,47630292,0.821917808219178,3,362,365
SRR25023041_1_val_1_bismark_bt2_pe.bismark.cov,controls,chr2,47630294,47630294,0.273972602739726,1,364,365
SRR25023041_1_val_1_bismark_bt2_pe.bismark.cov,controls,chr2,58468506,58468506,0.934579439252336,1,106,107
SRR25023041_1_val_1_bismark_bt2_pe.bismark.cov,controls,chr2,58468513,58468513,1.92307692307692,2,102,104
SRR25023041_1_val_1_bismark_bt2_pe.bismark.cov,controls,chr2,58468519,58468519,0.970873786407767,1,102,103
SRR25023041_1_val_1_bismark_bt2_pe.bismark.cov,controls,chr2,58468523,58468523,0.980392156862745,1,101,102
SRR25023041_1_val_1_bismark_bt2_pe.bismark.cov,controls,chr2,58468527,58468527,0.980392156862745,1,101,102
SRR25023041_1_val_1_bismark_bt2_pe.bismark.cov,controls,chr2,58468530,58468530,0.0,0,102,102
SRR25023041_1_val_1_bismark_bt2_pe.bismark.cov,controls,chr2,58468532,58468532,0.0,0,102,102
SRR25023041_1_val_1_bismark_bt2_pe.bismark.cov,controls,chr2,58468537,58468537,0.980392156862745,1,101,102
SRR25023041_1_val_1_bismark_bt2_pe.bismark.cov,controls,chr2,58468555,58468555,0.0,0,98,98
SRR25023041_1_val_1_bismark_bt2_pe.bismark.cov,controls,chr2,58468576,58468576,0.0,0,95,95
SRR25023041_1_val_1_bismark_bt2_pe.bismark.cov,controls,chr2,58468578,58468578,0.0,0,96,96
SRR25023041_1_val_1_bismark_bt2_pe.bismark.cov,controls,chr2,58468582,58468582,2.10526315789474,2,93,95
SRR25023041_1_val_1_bismark_bt2_pe.bismark.cov,controls,chr2,58468599,58468599,0.0,0,91,91
SRR25023041_1_val_1_bismark_bt2_pe.bismark.cov,controls,chr2,58468618,58468618,1.58730158730159,1,62,63
SRR25023041_1_val_1_bismark_bt2_pe.bismark.cov,controls,chr2,58468625,58468625,0.0,0,56,56
SRR25023041_1_val_1_bismark_bt2_pe.bismark.cov,controls,chr2,58468632,58468632,0.0,0,57,57
SRR25023041_1_val_1_bismark_bt2_pe.bismark.cov,controls,chr2,58468652,58468652,1.23456790123457,1,80,81
SRR25023041_1_val_1_bismark_bt2_pe.bismark.cov,controls,chr2,58468737,58468737,1.88679245283019,2,104,106
SRR25023041_1_val_1_bismark_bt2_pe.bismark.cov,controls,chr2,58468823,58468823,0.925925925925926,1,107,108
SRR25023041_1_val_1_bismark_bt2_pe.bismark.cov,controls,chr2,128051674,128051674,0.0,0,57,57
SRR25023041_1_val_1_bismark_bt2_pe.bismark.cov,controls,chr2,128051690,128051690,1.03626943005181,2,191,193
SRR25023041_1_val_1_bismark_bt2_pe.bismark.cov,controls,chr2,128051704,128051704,0.515463917525773,1,193,194
SRR25023041_1_val_1_bismark_bt2_pe.bismark.cov,controls,chr2,128051707,128051707,0.515463917525773,1,193,194
SRR25023041_1_val_1_bismark_bt2_pe.bismark.cov,controls,chr2,128051709,128051709,0.512820512820513,1,194,195
SRR25023041_1_val_1_bismark_bt2_pe.bismark.cov,controls,chr2,128051716,128051716,1.02564102564103,2,193,195
SRR25023041_1_val_1_bismark_bt2_pe.bismark.cov,controls,chr2,128051733,128051733,1.54639175257732,3,191,194
SRR25023041_1_val_1_bismark_bt2_pe.bismark.cov,controls,chr2,128051743,128051743,1.03092783505155,2,192,194
SRR25023041_1_val_1_bismark_bt2_pe.bismark.cov,controls,chr14,45604787,45604787,0.546448087431694,1,182,183
SRR25023041_1_val_1_bismark_bt2_pe.bismark.cov,controls,chr14,45604794,45604794,0.546448087431694,1,182,183
SRR25023041_1_val_1_bismark_bt2_pe.bismark.cov,controls,chr11,22647545,22647545,0.0,0,48,48
SRR25023041_1_val_1_bismark_bt2_pe.bismark.cov,controls,chr11,22647600,22647600,0.0,0,39,39
SRR25023041_1_val_1_bismark_bt2_pe.bismark.cov,controls,chr11,22647610,22647610,0.0,0,38,38
SRR25023041_1_val_1_bismark_bt2_pe.bismark.cov,controls,chr11,22647618,22647618,0.0,0,31,31
SRR25023041_1_val_1_bismark_bt2_pe.bismark.cov,controls,chr11,22647622,22647622,0.0,0,31,31
SRR25023041_1_val_1_bismark_bt2_pe.bismark.cov,controls,chr11,22647643,22647643,0.0,0,22,22
SRR25023041_1_val_1_bismark_bt2_pe.bismark.cov,controls,chr11,22647649,22647649,0.0,0,27,27
SRR25023041_1_val_1_bismark_bt2_pe.bismark.cov,controls,chr11,22647651,22647651,0.0,0,27,27
SRR25023041_1_val_1_bismark_bt2_pe.bismark.cov,controls,chr11,22647661,22647661,0.0,0,30,30
SRR25023041_1_val_1_bismark_bt2_pe.bismark.cov,controls,chr11,22647745,22647745,0.0,0,51,51
SRR25023041_1_val_1_bismark_bt2_pe.bismark.cov,controls,chr11,22647764,22647764,1.96078431372549,1,50,51
SRR25023041_1_val_1_bismark_bt2_pe.bismark.cov,controls,chr11,22647774,22647774,0.0,0,51,51
SRR25023041_1_val_1_bismark_bt2_pe.bismark.cov,controls,chr11,22647849,22647849,60.7843137254902,31,20,51
SRR25023041_1_val_1_bismark_bt2_pe.bismark.cov,controls,chr11,108093323,108093323,0.854700854700855,1,116,117
SRR25023041_1_val_1_bismark_bt2_pe.bismark.cov,controls,chr11,108093335,108093335,0.847457627118644,1,117,118
SRR25023041_1_val_1_bismark_bt2_pe.bismark.cov,controls,chr11,108093338,108093338,0.847457627118644,1,117,118
SRR25023041_1_val_1_bismark_bt2_pe.bismark.cov,controls,chr11,108093359,108093359,0.0,0,116,116
SRR25023041_1_val_1_bismark_bt2_pe.bismark.cov,controls,chr11,108093371,108093371,1.04166666666667,1,95,96
SRR25023041_1_val_1_bismark_bt2_pe.bismark.cov,controls,chr11,108093373,108093373,2.08333333333333,2,94,96
SRR25023041_1_val_1_bismark_bt2_pe.bismark.cov,controls,chr11,108093386,108093386,1.04166666666667,1,95,96
SRR25023041_1_val_1_bismark_bt2_pe.bismark.cov,controls,chr11,108093395,108093395,1.04166666666667,1,95,96
SRR25023041_1_val_1_bismark_bt2_pe.bismark.cov,controls,chr11,108093402,108093402,0.0,0,96,96
SRR25023041_1_val_1_bismark_bt2_pe.bismark.cov,controls,chr11,108093413,108093413,2.08333333333333,2,94,96
SRR25023041_1_val_1_bismark_bt2_pe.bismark.cov,controls,chr11,108093419,108093419,0.0,0,96,96
SRR25023041_1_val_1_bismark_bt2_pe.bismark.cov,controls,chr11,108093436,108093436,1.06382978723404,1,93,94
SRR25023041_1_val_1_bismark_bt2_pe.bismark.cov,controls,chr11,108093439,108093439,0.0,0,94,94
SRR25023041_1_val_1_bismark_bt2_pe.bismark.cov,controls,chr11,108093451,108093451,0.0,0,94,94
SRR25023041_1_val_1_bismark_bt2_pe.bismark.cov,controls,chr11,108093457,108093457,0.0,0,93,93
SRR25023041_1_val_1_bismark_bt2_pe.bismark.cov,controls,chr11,108093461,108093461,0.0,0,92,92
SRR25023041_1_val_1_bismark_bt2_pe.bismark.cov,controls,chr11,108093467,108093467,1.0989010989011,1,90,91
SRR25023041_1_val_1_bismark_bt2_pe.bismark.cov,controls,chr11,108093476,108093476,0.0,0,85,85
SRR25023041_1_val_1_bismark_bt2_pe.bismark.cov,controls,chr11,108093485,108093485,0.0,0,80,80
SRR25023041_1_val_1_bismark_bt2_pe.bismark.cov,controls,chr11,108093505,108093505,0.0,0,49,49
SRR25023041_1_val_1_bismark_bt2_pe.bismark.cov,controls,chr11,108093560,108093560,0.0,0,62,62
SRR25023041_1_val_1_bismark_bt2_pe.bismark.cov,controls,chr11,108093567,108093567,0.0,0,68,68
SRR25023041_1_val_1_bismark_bt2_pe.bismark.cov,controls,chr11,108093572,108093572,1.36986301369863,1,72,73
SRR25023041_1_val_1_bismark_bt2_pe.bismark.cov,controls,chr11,108093579,108093579,0.0,0,76,76
SRR25023041_1_val_1_bismark_bt2_pe.bismark.cov,controls,chr11,108093584,108093584,0.0,0,80,80
SRR25023041_1_val_1_bismark_bt2_pe.bismark.cov,controls,chr11,108093590,108093590,0.0,0,93,93
SRR25023041_1_val_1_bismark_bt2_pe.bismark.cov,controls,chr11,108093598,108093598,0.0,0,96,96
SRR25023041_1_val_1_bismark_bt2_pe.bismark.cov,controls,chr10,89619506,89619506,98.4771573604061,194,3,197
SRR25023041_1_val_1_bismark_bt2_pe.bismark.cov,controls,chr10,89619510,89619510,97.9695431472081,193,4,197
SRR25023041_1_val_1_bismark_bt2_pe.bismark.cov,controls,chr10,89619512,89619512,98.4771573604061,194,3,197
SRR25023041_1_val_1_bismark_bt2_pe.bismark.cov,controls,chr10,89619522,89619522,97.4619289340102,192,5,197
SRR25023041_1_val_1_bismark_bt2_pe.bismark.cov,controls,chr10,89619550,89619550,97.9695431472081,193,4,197
SRR25023041_1_val_1_bismark_bt2_pe.bismark.cov,controls,chr10,89619555,89619555,98.9847715736041,195,2,197
SRR25023041_1_val_1_bismark_bt2_pe.bismark.cov,controls,chr10,89619566,89619566,91.8367346938776,180,16,196
SRR25023041_1_val_1_bismark_bt2_pe.bismark.cov,controls,chr10,89619580,89619580,94.4162436548223,186,11,197
SRR25023041_1_val_1_bismark_bt2_pe.bismark.cov,controls,chr6,43543548,43543548,1.88679245283019,3,156,159
SRR25023041_1_val_1_bismark_bt2_pe.bismark.cov,controls,chr6,43543554,43543554,1.25,2,158,160
SRR25023041_1_val_1_bismark_bt2_pe.bismark.cov,controls,chr6,43543571,43543571,1.875,3,157,160
SRR25023041_1_val_1_bismark_bt2_pe.bismark.cov,controls,chr6,43543578,43543578,0.625,1,159,160
SRR25023041_1_val_1_bismark_bt2_pe.bismark.cov,controls,chr6,43543580,43543580,0.625,1,159,160
SRR25023041_1_val_1_bismark_bt2_pe.bismark.cov,controls,chr6,43543596,43543596,0.0,0,161,161
SRR25023041_1_val_1_bismark_bt2_pe.bismark.cov,controls,chr6,43543608,43543608,0.0,0,161,161
SRR25023041_1_val_1_bismark_bt2_pe.bismark.cov,controls,chr6,43543613,43543613,0.0,0,161,161
SRR25023041_1_val_1_bismark_bt2_pe.bismark.cov,controls,chr6,43543615,43543615,0.62111801242236,1,160,161
SRR25023041_1_val_1_bismark_bt2_pe.bismark.cov,controls,chr6,43543618,43543618,0.0,0,161,161
SRR25023041_1_val_1_bismark_bt2_pe.bismark.cov,controls,chr6,43543624,43543624,0.0,0,160,160
SRR25023041_1_val_1_bismark_bt2_pe.bismark.cov,controls,chr6,43543642,43543642,0.625,1,159,160
SRR25023041_1_val_1_bismark_bt2_pe.bismark.cov,controls,chr6,43543650,43543650,0.0,0,166,166
SRR25023041_1_val_1_bismark_bt2_pe.bismark.cov,controls,chr6,43543657,43543657,0.0,0,166,166
SRR25023041_1_val_1_bismark_bt2_pe.bismark.cov,controls,chr6,43543669,43543669,0.0,0,166,166
SRR25023041_1_val_1_bismark_bt2_pe.bismark.cov,controls,chr6,43543672,43543672,0.0,0,164,164
SRR25023041_1_val_1_bismark_bt2_pe.bismark.cov,controls,chr6,43543682,43543682,2.4390243902439,4,160,164
SRR25023041_1_val_1_bismark_bt2_pe.bismark.cov,controls,chr6,43543691,43543691,0.0,0,164,164
SRR25023041_1_val_1_bismark_bt2_pe.bismark.cov,controls,chr6,43543696,43543696,7.31707317073171,12,152,164
SRR25023041_1_val_1_bismark_bt2_pe.bismark.cov,controls,chr6,43543698,43543698,0.0,0,162,162
SRR25023041_1_val_1_bismark_bt2_pe.bismark.cov,controls,chr6,43543701,43543701,3.72670807453416,6,155,161
SRR25023041_1_val_1_bismark_bt2_pe.bismark.cov,controls,chr6,43543705,43543705,0.0,0,159,159
SRR25023041_1_val_1_bismark_bt2_pe.bismark.cov,controls,chr6,43543708,43543708,0.0,0,156,156
SRR25023041_1_val_1_bismark_bt2_pe.bismark.cov,controls,chr6,43543733,43543733,0.0,0,141,141
SRR25023041_1_val_1_bismark_bt2_pe.bismark.cov,controls,chr6,43543747,43543747,0.0,0,149,149
SRR25023041_1_val_1_bismark_bt2_pe.bismark.cov,controls,chr6,43543749,43543749,0.0,0,150,150
SRR25023041_1_val_1_bismark_bt2_pe.bismark.cov,controls,chr6,43543763,43543763,0.0,0,147,147
SRR25023041_1_val_1_bismark_bt2_pe.bismark.cov,controls,chr6,43543766,43543766,2.02702702702703,3,145,148
SRR25023041_1_val_1_bismark_bt2_pe.bismark.cov,controls,chr6,43543771,43543771,0.662251655629139,1,150,151
SRR25023041_1_val_1_bismark_bt2_pe.bismark.cov,controls,chr6,43543775,43543775,0.0,0,151,151
SRR25023041_1_val_1_bismark_bt2_pe.bismark.cov,controls,chr6,43543777,43543777,0.0,0,150,150
SRR25023041_1_val_1_bismark_bt2_pe.bismark.cov,controls,chr6,43543781,43543781,0.0,0,154,154
SRR25023041_1_val_1_bismark_bt2_pe.bismark.cov,controls,chr6,43543786,43543786,0.645161290322581,1,154,155
SRR25023041_1_val_1_bismark_bt2_pe.bismark.cov,controls,chr6,43543794,43543794,1.26582278481013,2,156,158
SRR25023041_1_val_1_bismark_bt2_pe.bismark.cov,controls,chr6,43543798,43543798,0.641025641025641,1,155,156
SRR25023041_1_val_1_bismark_bt2_pe.bismark.cov,controls,chr6,43543800,43543800,1.86335403726708,3,158,161
SRR25023041_1_val_1_bismark_bt2_pe.bismark.cov,controls,chr6,43543804,43543804,0.0,0,161,161
SRR25023041_1_val_1_bismark_bt2_pe.bismark.cov,controls,chr6,43543806,43543806,0.62111801242236,1,160,161
SRR25023041_1_val_1_bismark_bt2_pe.bismark.cov,controls,chr6,43543815,43543815,0.609756097560976,1,163,164
SRR25023041_1_val_1_bismark_bt2_pe.bismark.cov,controls,chr6,43543822,43543822,2.38095238095238,4,164,168
SRR25023041_1_val_1_bismark_bt2_pe.bismark.cov,controls,chr15,89786999,89786999,3.38983050847458,2,57,59
SRR25023041_1_val_1_bismark_bt2_pe.bismark.cov,controls,chr15,89787007,89787007,3.44827586206897,2,56,58
SRR25023041_1_val_1_bismark_bt2_pe.bismark.cov,controls,chr15,89787009,89787009,0.0,0,58,58
SRR25023041_1_val_1_bismark_bt2_pe.bismark.cov,controls,chr15,89787018,89787018,0.0,0,58,58
SRR25023041_1_val_1_bismark_bt2_pe.bismark.cov,controls,chr15,89787032,89787032,0.0,0,58,58
SRR25023041_1_val_1_bismark_bt2_pe.bismark.cov,controls,chr15,89787034,89787034,0.0,0,58,58
SRR25023041_1_val_1_bismark_bt2_pe.bismark.cov,controls,chr15,89787036,89787036,0.0,0,58,58
SRR25023041_1_val_1_bismark_bt2_pe.bismark.cov,controls,chr15,89787045,89787045,0.0,0,58,58
SRR25023041_1_val_1_bismark_bt2_pe.bismark.cov,controls,chr15,89787048,89787048,0.0,0,58,58
SRR25023041_1_val_1_bismark_bt2_pe.bismark.cov,controls,chr15,89787058,89787058,0.0,0,58,58
SRR25023041_1_val_1_bismark_bt2_pe.bismark.cov,controls,chr15,89787060,89787060,0.0,0,58,58
SRR25023041_1_val_1_bismark_bt2_pe.bismark.cov,controls,chr15,89787066,89787066,0.0,0,58,58
SRR25023041_1_val_1_bismark_bt2_pe.bismark.cov,controls,chr15,89787077,89787077,0.0,0,58,58
SRR25023041_1_val_1_bismark_bt2_pe.bismark.cov,controls,chr15,89787087,89787087,5.17241379310345,3,55,58
SRR25023041_1_val_1_bismark_bt2_pe.bismark.cov,controls,chr15,89787103,89787103,0.0,0,58,58
SRR25023041_1_val_1_bismark_bt2_pe.bismark.cov,controls,chr15,89787109,89787109,0.0,0,56,56
SRR25023041_1_val_1_bismark_bt2_pe.bismark.cov,controls,chr15,89787113,89787113,0.0,0,58,58
SRR25023041_1_val_1_bismark_bt2_pe.bismark.cov,controls,chr15,89787120,89787120,0.0,0,58,58
SRR25023041_1_val_1_bismark_bt2_pe.bismark.cov,controls,chr15,89787150,89787150,0.0,0,55,55
SRR25023041_1_val_1_bismark_bt2_pe.bismark.cov,controls,chr15,89787154,89787154,1.81818181818182,1,54,55
SRR25023041_1_val_1_bismark_bt2_pe.bismark.cov,controls,chr15,89787164,89787164,0.0,0,48,48
SRR25023041_1_val_1_bismark_bt2_pe.bismark.cov,controls,chr15,89787168,89787168,0.0,0,48,48
SRR25023041_1_val_1_bismark_bt2_pe.bismark.cov,controls,chr15,89787171,89787171,2.17391304347826,1,45,46
SRR25023041_1_val_1_bismark_bt2_pe.bismark.cov,controls,chr15,89787182,89787182,0.0,0,43,43
SRR25023041_1_val_1_bismark_bt2_pe.bismark.cov,controls,chr15,89787184,89787184,0.0,0,42,42
SRR25023041_1_val_1_bismark_bt2_pe.bismark.cov,controls,chr15,89787190,89787190,2.77777777777778,1,35,36
SRR25023041_1_val_1_bismark_bt2_pe.bismark.cov,controls,chr15,89787205,89787205,0.0,0,23,23
SRR25023041_1_val_1_bismark_bt2_pe.bismark.cov,controls,chr15,89787212,89787212,4.76190476190476,1,20,21
SRR25023041_1_val_1_bismark_bt2_pe.bismark.cov,controls,chr15,89787238,89787238,0.0,0,24,24
SRR25023041_1_val_1_bismark_bt2_pe.bismark.cov,controls,chr15,89787260,89787260,0.0,0,31,31
SRR25023041_1_val_1_bismark_bt2_pe.bismark.cov,controls,chr15,89787272,89787272,0.0,0,33,33
SRR25023041_1_val_1_bismark_bt2_pe.bismark.cov,controls,chr15,89787288,89787288,0.0,0,37,37
SRR25023041_1_val_1_bismark_bt2_pe.bismark.cov,controls,chr15,89787293,89787293,0.0,0,42,42
SRR25023041_1_val_1_bismark_bt2_pe.bismark.cov,controls,chr15,89787295,89787295,2.4390243902439,1,40,41
SRR25023041_1_val_1_bismark_bt2_pe.bismark.cov,controls,chr15,89787304,89787304,0.0,0,51,51
SRR25023041_1_val_1_bismark_bt2_pe.bismark.cov,controls,chr15,89787335,89787335,3.38983050847458,2,57,59
SRR25023041_1_val_1_bismark_bt2_pe.bismark.cov,controls,chr16,23652769,23652769,0.353356890459364,1,282,283
SRR25023041_1_val_1_bismark_bt2_pe.bismark.cov,controls,chr16,23652783,23652783,0.719424460431655,2,276,278
SRR25023041_1_val_1_bismark_bt2_pe.bismark.cov,controls,chr16,23652787,23652787,0.72202166064982,2,275,277
SRR25023041_1_val_1_bismark_bt2_pe.bismark.cov,controls,chr16,23652797,23652797,0.364963503649635,1,273,274
SRR25023041_1_val_1_bismark_bt2_pe.bismark.cov,controls,chr16,23652818,23652818,0.754716981132076,2,263,265
SRR25023041_1_val_1_bismark_bt2_pe.bismark.cov,controls,chr16,23652838,23652838,0.37037037037037,1,269,270
SRR25023041_1_val_1_bismark_bt2_pe.bismark.cov,controls,chr16,23652857,23652857,1.0752688172043,3,276,279
SRR25023041_1_val_1_bismark_bt2_pe.bismark.cov,controls,chr16,23652860,23652860,0.0,0,277,277
SRR25023041_1_val_1_bismark_bt2_pe.bismark.cov,controls,chr16,23652876,23652876,0.716845878136201,2,277,279
SRR25023041_1_val_1_bismark_bt2_pe.bismark.cov,controls,chr16,23652906,23652906,0.714285714285714,2,278,280
SRR25023041_1_val_1_bismark_bt2_pe.bismark.cov,controls,chr16,23652911,23652911,0.357142857142857,1,279,280
SRR25023041_1_val_1_bismark_bt2_pe.bismark.cov,controls,chr16,23652916,23652916,0.709219858156028,2,280,282
SRR25023041_1_val_1_bismark_bt2_pe.bismark.cov,controls,chr16,23652918,23652918,0.714285714285714,2,278,280
SRR25023041_1_val_1_bismark_bt2_pe.bismark.cov,controls,chr7,6048869,6048869,0.754527162977867,15,1973,1988
SRR25023041_1_val_1_bismark_bt2_pe.bismark.cov,controls,chr7,6048876,6048876,0.956215400100654,19,1968,1987
SRR25023041_1_val_1_bismark_bt2_pe.bismark.cov,controls,chr7,6048884,6048884,0.656565656565657,13,1967,1980
SRR25023041_1_val_1_bismark_bt2_pe.bismark.cov,controls,chr7,6048888,6048888,0.455235204855842,9,1968,1977
SRR25023041_1_val_1_bismark_bt2_pe.bismark.cov,controls,chr7,6048892,6048892,0.252652854977261,5,1974,1979
SRR25023041_1_val_1_bismark_bt2_pe.bismark.cov,controls,chr7,6048904,6048904,0.235849056603774,1,423,424
SRR25023041_1_val_1_bismark_bt2_pe.bismark.cov,controls,chr7,6048918,6048918,1.00704934541793,20,1966,1986
SRR25023041_1_val_1_bismark_bt2_pe.bismark.cov,controls,chr7,6048925,6048925,0.656234225138819,13,1968,1981
SRR25023041_1_val_1_bismark_bt2_pe.bismark.cov,controls,chr7,6048928,6048928,0.604838709677419,12,1972,1984
SRR25023041_1_val_1_bismark_bt2_pe.bismark.cov,controls,chr7,6048940,6048940,0.654582074521652,13,1973,1986
SRR25023041_1_val_1_bismark_bt2_pe.bismark.cov,controls,chr7,6048951,6048951,0.804828973843058,16,1972,1988
SRR25023041_1_val_1_bismark_bt2_pe.bismark.cov,controls,chr7,6048966,6048966,0.905432595573441,18,1970,1988
SRR25023041_1_val_1_bismark_bt2_pe.bismark.cov,controls,chr7,6048968,6048968,0.603621730382294,12,1976,1988
SRR25023041_1_val_1_bismark_bt2_pe.bismark.cov,controls,chr22,29137950,29137950,0.0,0,33,33
SRR25023041_1_val_1_bismark_bt2_pe.bismark.cov,controls,chr22,29137964,29137964,0.0,0,28,28
SRR25023041_1_val_1_bismark_bt2_pe.bismark.cov,controls,chr22,29137975,29137975,0.0,0,25,25
SRR25023041_1_val_1_bismark_bt2_pe.bismark.cov,controls,chr22,29137985,29137985,0.0,0,21,21
SRR25023041_1_val_1_bismark_bt2_pe.bismark.cov,controls,chr22,29138052,29138052,0.0,0,21,21
SRR25023041_1_val_1_bismark_bt2_pe.bismark.cov,controls,chr22,29138062,29138062,0.0,0,23,23
SRR25023041_1_val_1_bismark_bt2_pe.bismark.cov,controls,chr22,29138075,29138075,3.84615384615385,1,25,26
SRR25023041_1_val_1_bismark_bt2_pe.bismark.cov,controls,chr22,29138078,29138078,0.0,0,27,27
SRR25023041_1_val_1_bismark_bt2_pe.bismark.cov,controls,chr22,29138091,29138091,0.0,0,28,28
SRR25023041_1_val_1_bismark_bt2_pe.bismark.cov,controls,chr22,29138102,29138102,0.0,0,33,33
SRR25023041_1_val_1_bismark_bt2_pe.bismark.cov,controls,chr22,29138115,29138115,0.0,0,33,33
SRR25023041_1_val_1_bismark_bt2_pe.bismark.cov,controls,chr22,29138134,29138134,3.03030303030303,1,32,33
SRR25023041_1_val_1_bismark_bt2_pe.bismark.cov,controls,chr22,29138158,29138158,0.0,0,35,35
SRR25023041_1_val_1_bismark_bt2_pe.bismark.cov,controls,chr22,29138168,29138168,0.0,0,35,35
SRR25023041_1_val_1_bismark_bt2_pe.bismark.cov,controls,chr22,29138176,29138176,0.0,0,35,35
SRR25023041_1_val_1_bismark_bt2_pe.bismark.cov,controls,chr22,29138179,29138179,0.0,0,35,35
SRR25023041_1_val_1_bismark_bt2_pe.bismark.cov,controls,chr22,29138185,29138185,0.0,0,36,36
SRR25023041_1_val_1_bismark_bt2_pe.bismark.cov,controls,chr22,29138202,29138202,5.55555555555556,2,34,36
SRR25023041_1_val_1_bismark_bt2_pe.bismark.cov,controls,chr22,29138216,29138216,0.0,0,36,36
SRR25023041_1_val_1_bismark_bt2_pe.bismark.cov,controls,chr22,29138219,29138219,0.0,0,36,36
SRR25023041_1_val_1_bismark_bt2_pe.bismark.cov,controls,chr22,29138234,29138234,0.0,0,36,36
SRR25023041_1_val_1_bismark_bt2_pe.bismark.cov,controls,chr22,29138238,29138238,0.0,0,33,33
SRR25023042_1_val_1_bismark_bt2_pe.bismark.cov,controls,chr13,32889392,32889392,20.6387035271687,433,1665,2098
SRR25023042_1_val_1_bismark_bt2_pe.bismark.cov,controls,chr13,32889434,32889434,2.91586998087954,61,2031,2092
SRR25023042_1_val_1_bismark_bt2_pe.bismark.cov,controls,chr13,32889461,32889461,0.859598853868195,18,2076,2094
SRR25023042_1_val_1_bismark_bt2_pe.bismark.cov,controls,chr13,32889470,32889470,0.430416068866571,9,2082,2091
SRR25023042_1_val_1_bismark_bt2_pe.bismark.cov,controls,chr13,32889484,32889484,0.334608030592734,7,2085,2092
SRR25023042_1_val_1_bismark_bt2_pe.bismark.cov,controls,chr3,37034307,37034307,100.0,1796,0,1796
SRR25023042_1_val_1_bismark_bt2_pe.bismark.cov,controls,chr3,37034316,37034316,0.335382895472331,6,1783,1789
SRR25023042_1_val_1_bismark_bt2_pe.bismark.cov,controls,chr3,37034324,37034324,0.223463687150838,4,1786,1790
SRR25023042_1_val_1_bismark_bt2_pe.bismark.cov,controls,chr3,37034330,37034330,0.11154489682097,2,1791,1793
SRR25023042_1_val_1_bismark_bt2_pe.bismark.cov,controls,chr3,37034344,37034344,0.948660714285714,17,1775,1792
SRR25023042_1_val_1_bismark_bt2_pe.bismark.cov,controls,chr3,37034346,37034346,0.223463687150838,4,1786,1790
SRR25023042_1_val_1_bismark_bt2_pe.bismark.cov,controls,chr3,37034348,37034348,0.669642857142857,12,1780,1792
SRR25023042_1_val_1_bismark_bt2_pe.bismark.cov,controls,chr3,37034352,37034352,0.334634690462911,6,1787,1793
SRR25023042_1_val_1_bismark_bt2_pe.bismark.cov,controls,chr3,37034355,37034355,0.613839285714286,11,1781,1792
SRR25023042_1_val_1_bismark_bt2_pe.bismark.cov,controls,chr3,37034359,37034359,0.558035714285714,10,1782,1792
SRR25023042_1_val_1_bismark_bt2_pe.bismark.cov,controls,chr3,37034369,37034369,0.613154960981048,11,1783,1794
SRR25023042_1_val_1_bismark_bt2_pe.bismark.cov,controls,chr3,37034373,37034373,0.334448160535117,6,1788,1794
SRR25023042_1_val_1_bismark_bt2_pe.bismark.cov,controls,chr3,37034382,37034382,0.893854748603352,16,1774,1790
SRR25023042_1_val_1_bismark_bt2_pe.bismark.cov,controls,chr3,37034394,37034394,0.390407138873397,7,1786,1793
SRR25023042_1_val_1_bismark_bt2_pe.bismark.cov,controls,chr3,37034402,37034402,0.334634690462911,6,1787,1793
SRR25023042_1_val_1_bismark_bt2_pe.bismark.cov,controls,chr3,37034409,37034409,0.669269380925823,12,1781,1793
SRR25023042_1_val_1_bismark_bt2_pe.bismark.cov,controls,chr3,37034412,37034412,0.727069351230425,13,1775,1788
SRR25023042_1_val_1_bismark_bt2_pe.bismark.cov,controls,chr3,37034414,37034414,0.223089793641941,4,1789,1793
SRR25023042_1_val_1_bismark_bt2_pe.bismark.cov,controls,chr3,37034418,37034418,0.725041829336308,13,1780,1793
SRR25023042_1_val_1_bismark_bt2_pe.bismark.cov,controls,chr3,37034420,37034420,0.390625,7,1785,1792
SRR25023042_1_val_1_bismark_bt2_pe.bismark.cov,controls,chr3,37034430,37034430,0.891861761426979,16,1778,1794
SRR25023042_1_val_1_bismark_bt2_pe.bismark.cov,controls,chr3,37034438,37034438,1.1154489682097,20,1773,1793
SRR25023042_1_val_1_bismark_bt2_pe.bismark.cov,controls,chr3,37034441,37034441,0.725041829336308,13,1780,1793
SRR25023042_1_val_1_bismark_bt2_pe.bismark.cov,controls,chr3,37034466,37034466,99.8883305415969,1789,2,1791
SRR25023042_1_val_1_bismark_bt2_pe.bismark.cov,controls,chr3,37034997,37034997,0.422450211225106,7,1650,1657
SRR25023042_1_val_1_bismark_bt2_pe.bismark.cov,controls,chr3,37035012,37035012,0.36231884057971,6,1650,1656
SRR25023042_1_val_1_bismark_bt2_pe.bismark.cov,controls,chr3,37035032,37035032,0.66626287098728,11,1640,1651
SRR25023042_1_val_1_bismark_bt2_pe.bismark.cov,controls,chr3,37035043,37035043,0.605326876513317,10,1642,1652
SRR25023042_1_val_1_bismark_bt2_pe.bismark.cov,controls,chr3,37035047,37035047,0.424757281553398,7,1641,1648
SRR25023042_1_val_1_bismark_bt2_pe.bismark.cov,controls,chr3,37035063,37035063,0.667880995749848,11,1636,1647
SRR25023042_1_val_1_bismark_bt2_pe.bismark.cov,controls,chr3,37035066,37035066,0.667880995749848,11,1636,1647
SRR25023042_1_val_1_bismark_bt2_pe.bismark.cov,controls,chr3,37035074,37035074,0.54678007290401,9,1637,1646
SRR25023042_1_val_1_bismark_bt2_pe.bismark.cov,controls,chr3,37035090,37035090,1.45366444579043,24,1627,1651
SRR25023042_1_val_1_bismark_bt2_pe.bismark.cov,controls,chr3,37035095,37035095,0.970285021224985,16,1633,1649
SRR25023042_1_val_1_bismark_bt2_pe.bismark.cov,controls,chr3,37035097,37035097,0.545124167171411,9,1642,1651
SRR25023042_1_val_1_bismark_bt2_pe.bismark.cov,controls,chr3,37035100,37035100,0.485436893203883,8,1640,1648
SRR25023042_1_val_1_bismark_bt2_pe.bismark.cov,controls,chr3,37035117,37035117,0.483968542044767,8,1645,1653
SRR25023042_1_val_1_bismark_bt2_pe.bismark.cov,controls,chr3,142297977,142297977,0.0,0,94,94
SRR25023042_1_val_1_bismark_bt2_pe.bismark.cov,controls,chr3,142298019,142298019,0.0,0,94,94
SRR25023042_1_val_1_bismark_bt2_pe.bismark.cov,controls,chr3,142298045,142298045,2.12765957446809,2,92,94
SRR25023042_1_val_1_bismark_bt2_pe.bismark.cov,controls,chr3,142298054,142298054,6.45161290322581,6,87,93
SRR25023042_1_val_1_bismark_bt2_pe.bismark.cov,controls,chr14,45604787,45604787,0.0,0,173,173
SRR25023042_1_val_1_bismark_bt2_pe.bismark.cov,controls,chr14,45604794,45604794,0.578034682080925,1,172,173
SRR25023042_1_val_1_bismark_bt2_pe.bismark.cov,controls,chr2,47596828,47596828,3.47417840375587,37,1028,1065
SRR25023042_1_val_1_bismark_bt2_pe.bismark.cov,controls,chr2,47596830,47596830,3.74181478016838,40,1029,1069
SRR25023042_1_val_1_bismark_bt2_pe.bismark.cov,controls,chr2,47596840,47596840,3.65853658536585,39,1027,1066
SRR25023042_1_val_1_bismark_bt2_pe.bismark.cov,controls,chr2,47596849,47596849,14.2184557438795,151,911,1062
SRR25023042_1_val_1_bismark_bt2_pe.bismark.cov,controls,chr2,47596853,47596853,9.21501706484642,54,532,586
SRR25023042_1_val_1_bismark_bt2_pe.bismark.cov,controls,chr2,47596858,47596858,9.28705440900563,99,967,1066
SRR25023042_1_val_1_bismark_bt2_pe.bismark.cov,controls,chr2,47596862,47596862,6.58513640639699,70,993,1063
SRR25023042_1_val_1_bismark_bt2_pe.bismark.cov,controls,chr2,47596869,47596869,14.6341463414634,156,910,1066
SRR25023042_1_val_1_bismark_bt2_pe.bismark.cov,controls,chr2,47596883,47596883,13.7218045112782,146,918,1064
SRR25023042_1_val_1_bismark_bt2_pe.bismark.cov,controls,chr2,47596885,47596885,4.22932330827068,45,1019,1064
SRR25023042_1_val_1_bismark_bt2_pe.bismark.cov,controls,chr2,47596887,47596887,5.64971751412429,60,1002,1062
SRR25023042_1_val_1_bismark_bt2_pe.bismark.cov,controls,chr2,47596897,47596897,6.66666666666667,71,994,1065
SRR25023042_1_val_1_bismark_bt2_pe.bismark.cov,controls,chr2,47596900,47596900,5.17403574788335,55,1008,1063
SRR25023042_1_val_1_bismark_bt2_pe.bismark.cov,controls,chr2,47596907,47596907,2.64150943396226,28,1032,1060
SRR25023042_1_val_1_bismark_bt2_pe.bismark.cov,controls,chr2,47596912,47596912,3.58829084041549,38,1021,1059
SRR25023042_1_val_1_bismark_bt2_pe.bismark.cov,controls,chr2,47596930,47596930,5.08953817153629,54,1007,1061
SRR25023042_1_val_1_bismark_bt2_pe.bismark.cov,controls,chr2,47596942,47596942,6.30885122410546,67,995,1062
SRR25023042_1_val_1_bismark_bt2_pe.bismark.cov,controls,chr2,47630224,47630224,0.50125313283208,2,397,399
SRR25023042_1_val_1_bismark_bt2_pe.bismark.cov,controls,chr2,47630227,47630227,1.75,7,393,400
SRR25023042_1_val_1_bismark_bt2_pe.bismark.cov,controls,chr2,47630233,47630233,0.255102040816327,1,391,392
SRR25023042_1_val_1_bismark_bt2_pe.bismark.cov,controls,chr2,47630237,47630237,0.50125313283208,2,397,399
SRR25023042_1_val_1_bismark_bt2_pe.bismark.cov,controls,chr2,47630240,47630240,2.0,8,392,400
SRR25023042_1_val_1_bismark_bt2_pe.bismark.cov,controls,chr2,47630244,47630244,2.5,10,390,400
SRR25023042_1_val_1_bismark_bt2_pe.bismark.cov,controls,chr2,47630251,47630251,1.00250626566416,4,395,399
SRR25023042_1_val_1_bismark_bt2_pe.bismark.cov,controls,chr2,47630265,47630265,0.0,0,398,398
SRR25023042_1_val_1_bismark_bt2_pe.bismark.cov,controls,chr2,47630292,47630292,1.00250626566416,4,395,399
SRR25023042_1_val_1_bismark_bt2_pe.bismark.cov,controls,chr2,47630294,47630294,1.00755667506297,4,393,397
SRR25023042_1_val_1_bismark_bt2_pe.bismark.cov,controls,chr2,58468506,58468506,0.0,0,78,78
SRR25023042_1_val_1_bismark_bt2_pe.bismark.cov,controls,chr2,58468513,58468513,1.26582278481013,1,78,79
SRR25023042_1_val_1_bismark_bt2_pe.bismark.cov,controls,chr2,58468519,58468519,0.0,0,79,79
SRR25023042_1_val_1_bismark_bt2_pe.bismark.cov,controls,chr2,58468523,58468523,0.0,0,77,77
SRR25023042_1_val_1_bismark_bt2_pe.bismark.cov,controls,chr2,58468527,58468527,0.0,0,78,78
SRR25023042_1_val_1_bismark_bt2_pe.bismark.cov,controls,chr2,58468530,58468530,0.0,0,77,77
SRR25023042_1_val_1_bismark_bt2_pe.bismark.cov,controls,chr2,58468532,58468532,0.0,0,76,76
SRR25023042_1_val_1_bismark_bt2_pe.bismark.cov,controls,chr2,58468537,58468537,1.33333333333333,1,74,75
SRR25023042_1_val_1_bismark_bt2_pe.bismark.cov,controls,chr2,58468555,58468555,1.35135135135135,1,73,74
SRR25023042_1_val_1_bismark_bt2_pe.bismark.cov,controls,chr2,58468576,58468576,0.0,0,71,71
SRR25023042_1_val_1_bismark_bt2_pe.bismark.cov,controls,chr2,58468578,58468578,0.0,0,71,71
SRR25023042_1_val_1_bismark_bt2_pe.bismark.cov,controls,chr2,58468582,58468582,0.0,0,70,70
SRR25023042_1_val_1_bismark_bt2_pe.bismark.cov,controls,chr2,58468599,58468599,0.0,0,65,65
SRR25023042_1_val_1_bismark_bt2_pe.bismark.cov,controls,chr2,58468618,58468618,2.0,1,49,50
SRR25023042_1_val_1_bismark_bt2_pe.bismark.cov,controls,chr2,58468625,58468625,0.0,0,47,47
SRR25023042_1_val_1_bismark_bt2_pe.bismark.cov,controls,chr2,58468632,58468632,0.0,0,48,48
SRR25023042_1_val_1_bismark_bt2_pe.bismark.cov,controls,chr2,58468652,58468652,0.0,0,60,60
SRR25023042_1_val_1_bismark_bt2_pe.bismark.cov,controls,chr2,58468737,58468737,1.2987012987013,1,76,77
SRR25023042_1_val_1_bismark_bt2_pe.bismark.cov,controls,chr2,58468823,58468823,0.0,0,77,77
SRR25023042_1_val_1_bismark_bt2_pe.bismark.cov,controls,chr2,128051690,128051690,5.26315789473684,3,54,57
SRR25023042_1_val_1_bismark_bt2_pe.bismark.cov,controls,chr2,128051704,128051704,0.0,0,57,57
SRR25023042_1_val_1_bismark_bt2_pe.bismark.cov,controls,chr2,128051707,128051707,1.75438596491228,1,56,57
SRR25023042_1_val_1_bismark_bt2_pe.bismark.cov,controls,chr2,128051709,128051709,0.0,0,56,56
SRR25023042_1_val_1_bismark_bt2_pe.bismark.cov,controls,chr2,128051716,128051716,0.0,0,57,57
SRR25023042_1_val_1_bismark_bt2_pe.bismark.cov,controls,chr2,128051733,128051733,0.0,0,57,57
SRR25023042_1_val_1_bismark_bt2_pe.bismark.cov,controls,chr2,128051743,128051743,1.75438596491228,1,56,57
SRR25023042_1_val_1_bismark_bt2_pe.bismark.cov,controls,chr10,89619506,89619506,97.5961538461538,203,5,208
SRR25023042_1_val_1_bismark_bt2_pe.bismark.cov,controls,chr10,89619510,89619510,99.0384615384615,206,2,208
SRR25023042_1_val_1_bismark_bt2_pe.bismark.cov,controls,chr10,89619512,89619512,98.5576923076923,205,3,208
SRR25023042_1_val_1_bismark_bt2_pe.bismark.cov,controls,chr10,89619522,89619522,98.5576923076923,205,3,208
SRR25023042_1_val_1_bismark_bt2_pe.bismark.cov,controls,chr10,89619550,89619550,96.1538461538462,200,8,208
SRR25023042_1_val_1_bismark_bt2_pe.bismark.cov,controls,chr10,89619555,89619555,97.5961538461538,203,5,208
SRR25023042_1_val_1_bismark_bt2_pe.bismark.cov,controls,chr10,89619566,89619566,93.719806763285,194,13,207
SRR25023042_1_val_1_bismark_bt2_pe.bismark.cov,controls,chr10,89619580,89619580,95.1923076923077,198,10,208
SRR25023042_1_val_1_bismark_bt2_pe.bismark.cov,controls,chr6,43543548,43543548,0.390625,1,255,256
SRR25023042_1_val_1_bismark_bt2_pe.bismark.cov,controls,chr6,43543554,43543554,1.17647058823529,3,252,255
SRR25023042_1_val_1_bismark_bt2_pe.bismark.cov,controls,chr6,43543571,43543571,1.96078431372549,5,250,255
SRR25023042_1_val_1_bismark_bt2_pe.bismark.cov,controls,chr6,43543578,43543578,0.390625,1,255,256
SRR25023042_1_val_1_bismark_bt2_pe.bismark.cov,controls,chr6,43543580,43543580,0.390625,1,255,256
SRR25023042_1_val_1_bismark_bt2_pe.bismark.cov,controls,chr6,43543596,43543596,0.0,0,255,255
SRR25023042_1_val_1_bismark_bt2_pe.bismark.cov,controls,chr6,43543608,43543608,0.392156862745098,1,254,255
SRR25023042_1_val_1_bismark_bt2_pe.bismark.cov,controls,chr6,43543613,43543613,0.78125,2,254,256
SRR25023042_1_val_1_bismark_bt2_pe.bismark.cov,controls,chr6,43543615,43543615,1.171875,3,253,256
SRR25023042_1_val_1_bismark_bt2_pe.bismark.cov,controls,chr6,43543618,43543618,2.74509803921569,7,248,255
SRR25023042_1_val_1_bismark_bt2_pe.bismark.cov,controls,chr6,43543624,43543624,0.0,0,256,256
SRR25023042_1_val_1_bismark_bt2_pe.bismark.cov,controls,chr6,43543642,43543642,0.395256916996047,1,252,253
SRR25023042_1_val_1_bismark_bt2_pe.bismark.cov,controls,chr6,43543650,43543650,0.793650793650794,2,250,252
SRR25023042_1_val_1_bismark_bt2_pe.bismark.cov,controls,chr6,43543657,43543657,0.0,0,252,252
SRR25023042_1_val_1_bismark_bt2_pe.bismark.cov,controls,chr6,43543669,43543669,0.4,1,249,250
SRR25023042_1_val_1_bismark_bt2_pe.bismark.cov,controls,chr6,43543672,43543672,0.816326530612245,2,243,245
SRR25023042_1_val_1_bismark_bt2_pe.bismark.cov,controls,chr6,43543682,43543682,0.819672131147541,2,242,244
SRR25023042_1_val_1_bismark_bt2_pe.bismark.cov,controls,chr6,43543691,43543691,1.65289256198347,4,238,242
SRR25023042_1_val_1_bismark_bt2_pe.bismark.cov,controls,chr6,43543696,43543696,10.0840336134454,24,214,238
SRR25023042_1_val_1_bismark_bt2_pe.bismark.cov,controls,chr6,43543698,43543698,0.0,0,237,237
SRR25023042_1_val_1_bismark_bt2_pe.bismark.cov,controls,chr6,43543701,43543701,4.21940928270042,10,227,237
SRR25023042_1_val_1_bismark_bt2_pe.bismark.cov,controls,chr6,43543705,43543705,0.0,0,235,235
SRR25023042_1_val_1_bismark_bt2_pe.bismark.cov,controls,chr6,43543708,43543708,0.0,0,231,231
SRR25023042_1_val_1_bismark_bt2_pe.bismark.cov,controls,chr6,43543733,43543733,1.45631067961165,3,203,206
SRR25023042_1_val_1_bismark_bt2_pe.bismark.cov,controls,chr6,43543747,43543747,0.0,0,209,209
SRR25023042_1_val_1_bismark_bt2_pe.bismark.cov,controls,chr6,43543749,43543749,1.40845070422535,3,210,213
SRR25023042_1_val_1_bismark_bt2_pe.bismark.cov,controls,chr6,43543763,43543763,1.44230769230769,3,205,208
SRR25023042_1_val_1_bismark_bt2_pe.bismark.cov,controls,chr6,43543766,43543766,0.0,0,203,203
SRR25023042_1_val_1_bismark_bt2_pe.bismark.cov,controls,chr6,43543771,43543771,0.0,0,207,207
SRR25023042_1_val_1_bismark_bt2_pe.bismark.cov,controls,chr6,43543775,43543775,0.0,0,210,210
SRR25023042_1_val_1_bismark_bt2_pe.bismark.cov,controls,chr6,43543777,43543777,0.0,0,213,213
SRR25023042_1_val_1_bismark_bt2_pe.bismark.cov,controls,chr6,43543781,43543781,0.0,0,216,216
SRR25023042_1_val_1_bismark_bt2_pe.bismark.cov,controls,chr6,43543786,43543786,0.458715596330275,1,217,218
SRR25023042_1_val_1_bismark_bt2_pe.bismark.cov,controls,chr6,43543794,43543794,0.446428571428571,1,223,224
SRR25023042_1_val_1_bismark_bt2_pe.bismark.cov,controls,chr6,43543798,43543798,1.30434782608696,3,227,230
SRR25023042_1_val_1_bismark_bt2_pe.bismark.cov,controls,chr6,43543800,43543800,0.87719298245614,2,226,228
SRR25023042_1_val_1_bismark_bt2_pe.bismark.cov,controls,chr6,43543804,43543804,0.851063829787234,2,233,235
SRR25023042_1_val_1_bismark_bt2_pe.bismark.cov,controls,chr6,43543806,43543806,1.70212765957447,4,231,235
SRR25023042_1_val_1_bismark_bt2_pe.bismark.cov,controls,chr6,43543815,43543815,0.0,0,242,242
SRR25023042_1_val_1_bismark_bt2_pe.bismark.cov,controls,chr6,43543822,43543822,2.03252032520325,5,241,246
SRR25023042_1_val_1_bismark_bt2_pe.bismark.cov,controls,chr11,22647545,22647545,0.0,0,53,53
SRR25023042_1_val_1_bismark_bt2_pe.bismark.cov,controls,chr11,22647600,22647600,0.0,0,41,41
SRR25023042_1_val_1_bismark_bt2_pe.bismark.cov,controls,chr11,22647610,22647610,0.0,0,38,38
SRR25023042_1_val_1_bismark_bt2_pe.bismark.cov,controls,chr11,22647618,22647618,0.0,0,36,36
SRR25023042_1_val_1_bismark_bt2_pe.bismark.cov,controls,chr11,22647622,22647622,3.2258064516129,1,30,31
SRR25023042_1_val_1_bismark_bt2_pe.bismark.cov,controls,chr11,22647649,22647649,0.0,0,23,23
SRR25023042_1_val_1_bismark_bt2_pe.bismark.cov,controls,chr11,22647651,22647651,0.0,0,23,23
SRR25023042_1_val_1_bismark_bt2_pe.bismark.cov,controls,chr11,22647661,22647661,3.84615384615385,1,25,26
SRR25023042_1_val_1_bismark_bt2_pe.bismark.cov,controls,chr11,22647745,22647745,0.0,0,50,50
SRR25023042_1_val_1_bismark_bt2_pe.bismark.cov,controls,chr11,22647764,22647764,0.0,0,50,50
SRR25023042_1_val_1_bismark_bt2_pe.bismark.cov,controls,chr11,22647774,22647774,2.0,1,49,50
SRR25023042_1_val_1_bismark_bt2_pe.bismark.cov,controls,chr11,22647849,22647849,76.0,38,12,50
SRR25023042_1_val_1_bismark_bt2_pe.bismark.cov,controls,chr11,108093323,108093323,0.0,0,70,70
SRR25023042_1_val_1_bismark_bt2_pe.bismark.cov,controls,chr11,108093335,108093335,1.42857142857143,1,69,70
SRR25023042_1_val_1_bismark_bt2_pe.bismark.cov,controls,chr11,108093338,108093338,0.0,0,70,70
SRR25023042_1_val_1_bismark_bt2_pe.bismark.cov,controls,chr11,108093359,108093359,1.47058823529412,1,67,68
SRR25023042_1_val_1_bismark_bt2_pe.bismark.cov,controls,chr11,108093371,108093371,0.0,0,52,52
SRR25023042_1_val_1_bismark_bt2_pe.bismark.cov,controls,chr11,108093373,108093373,0.0,0,52,52
SRR25023042_1_val_1_bismark_bt2_pe.bismark.cov,controls,chr11,108093386,108093386,0.0,0,52,52
SRR25023042_1_val_1_bismark_bt2_pe.bismark.cov,controls,chr11,108093395,108093395,3.92156862745098,2,49,51
SRR25023042_1_val_1_bismark_bt2_pe.bismark.cov,controls,chr11,108093402,108093402,0.0,0,51,51
SRR25023042_1_val_1_bismark_bt2_pe.bismark.cov,controls,chr11,108093413,108093413,0.0,0,51,51
SRR25023042_1_val_1_bismark_bt2_pe.bismark.cov,controls,chr11,108093419,108093419,0.0,0,51,51
SRR25023042_1_val_1_bismark_bt2_pe.bismark.cov,controls,chr11,108093436,108093436,0.0,0,52,52
SRR25023042_1_val_1_bismark_bt2_pe.bismark.cov,controls,chr11,108093439,108093439,0.0,0,52,52
SRR25023042_1_val_1_bismark_bt2_pe.bismark.cov,controls,chr11,108093451,108093451,1.92307692307692,1,51,52
SRR25023042_1_val_1_bismark_bt2_pe.bismark.cov,controls,chr11,108093457,108093457,0.0,0,51,51
SRR25023042_1_val_1_bismark_bt2_pe.bismark.cov,controls,chr11,108093461,108093461,0.0,0,50,50
SRR25023042_1_val_1_bismark_bt2_pe.bismark.cov,controls,chr11,108093467,108093467,0.0,0,49,49
SRR25023042_1_val_1_bismark_bt2_pe.bismark.cov,controls,chr11,108093476,108093476,0.0,0,44,44
SRR25023042_1_val_1_bismark_bt2_pe.bismark.cov,controls,chr11,108093485,108093485,0.0,0,43,43
SRR25023042_1_val_1_bismark_bt2_pe.bismark.cov,controls,chr11,108093505,108093505,0.0,0,27,27
SRR25023042_1_val_1_bismark_bt2_pe.bismark.cov,controls,chr11,108093560,108093560,3.44827586206897,1,28,29
SRR25023042_1_val_1_bismark_bt2_pe.bismark.cov,controls,chr11,108093567,108093567,0.0,0,37,37
SRR25023042_1_val_1_bismark_bt2_pe.bismark.cov,controls,chr11,108093572,108093572,0.0,0,40,40
SRR25023042_1_val_1_bismark_bt2_pe.bismark.cov,controls,chr11,108093579,108093579,0.0,0,41,41
SRR25023042_1_val_1_bismark_bt2_pe.bismark.cov,controls,chr11,108093584,108093584,2.27272727272727,1,43,44
SRR25023042_1_val_1_bismark_bt2_pe.bismark.cov,controls,chr11,108093590,108093590,0.0,0,50,50
SRR25023042_1_val_1_bismark_bt2_pe.bismark.cov,controls,chr11,108093598,108093598,0.0,0,52,52
SRR25023042_1_val_1_bismark_bt2_pe.bismark.cov,controls,chr15,89786999,89786999,0.0,0,41,41
SRR25023042_1_val_1_bismark_bt2_pe.bismark.cov,controls,chr15,89787007,89787007,4.76190476190476,2,40,42
SRR25023042_1_val_1_bismark_bt2_pe.bismark.cov,controls,chr15,89787009,89787009,0.0,0,42,42
SRR25023042_1_val_1_bismark_bt2_pe.bismark.cov,controls,chr15,89787018,89787018,2.38095238095238,1,41,42
SRR25023042_1_val_1_bismark_bt2_pe.bismark.cov,controls,chr15,89787032,89787032,2.4390243902439,1,40,41
SRR25023042_1_val_1_bismark_bt2_pe.bismark.cov,controls,chr15,89787034,89787034,0.0,0,41,41
SRR25023042_1_val_1_bismark_bt2_pe.bismark.cov,controls,chr15,89787036,89787036,0.0,0,41,41
SRR25023042_1_val_1_bismark_bt2_pe.bismark.cov,controls,chr15,89787045,89787045,0.0,0,41,41
SRR25023042_1_val_1_bismark_bt2_pe.bismark.cov,controls,chr15,89787048,89787048,0.0,0,41,41
SRR25023042_1_val_1_bismark_bt2_pe.bismark.cov,controls,chr15,89787058,89787058,0.0,0,41,41
SRR25023042_1_val_1_bismark_bt2_pe.bismark.cov,controls,chr15,89787060,89787060,0.0,0,41,41
SRR25023042_1_val_1_bismark_bt2_pe.bismark.cov,controls,chr15,89787066,89787066,0.0,0,40,40
SRR25023042_1_val_1_bismark_bt2_pe.bismark.cov,controls,chr15,89787077,89787077,0.0,0,40,40
SRR25023042_1_val_1_bismark_bt2_pe.bismark.cov,controls,chr15,89787087,89787087,0.0,0,39,39
SRR25023042_1_val_1_bismark_bt2_pe.bismark.cov,controls,chr15,89787103,89787103,0.0,0,38,38
SRR25023042_1_val_1_bismark_bt2_pe.bismark.cov,controls,chr15,89787109,89787109,0.0,0,38,38
SRR25023042_1_val_1_bismark_bt2_pe.bismark.cov,controls,chr15,89787113,89787113,0.0,0,38,38
SRR25023042_1_val_1_bismark_bt2_pe.bismark.cov,controls,chr15,89787120,89787120,0.0,0,38,38
SRR25023042_1_val_1_bismark_bt2_pe.bismark.cov,controls,chr15,89787150,89787150,0.0,0,38,38
SRR25023042_1_val_1_bismark_bt2_pe.bismark.cov,controls,chr15,89787154,89787154,2.63157894736842,1,37,38
SRR25023042_1_val_1_bismark_bt2_pe.bismark.cov,controls,chr15,89787164,89787164,0.0,0,35,35
SRR25023042_1_val_1_bismark_bt2_pe.bismark.cov,controls,chr15,89787168,89787168,0.0,0,33,33
SRR25023042_1_val_1_bismark_bt2_pe.bismark.cov,controls,chr15,89787171,89787171,0.0,0,30,30
SRR25023042_1_val_1_bismark_bt2_pe.bismark.cov,controls,chr15,89787182,89787182,0.0,0,24,24
SRR25023042_1_val_1_bismark_bt2_pe.bismark.cov,controls,chr15,89787184,89787184,0.0,0,24,24
SRR25023042_1_val_1_bismark_bt2_pe.bismark.cov,controls,chr15,89787190,89787190,0.0,0,21,21
SRR25023042_1_val_1_bismark_bt2_pe.bismark.cov,controls,chr15,89787260,89787260,0.0,0,22,22
SRR25023042_1_val_1_bismark_bt2_pe.bismark.cov,controls,chr15,89787272,89787272,0.0,0,24,24
SRR25023042_1_val_1_bismark_bt2_pe.bismark.cov,controls,chr15,89787288,89787288,0.0,0,30,30
SRR25023042_1_val_1_bismark_bt2_pe.bismark.cov,controls,chr15,89787293,89787293,0.0,0,30,30
SRR25023042_1_val_1_bismark_bt2_pe.bismark.cov,controls,chr15,89787295,89787295,0.0,0,30,30
SRR25023042_1_val_1_bismark_bt2_pe.bismark.cov,controls,chr15,89787304,89787304,0.0,0,33,33
SRR25023042_1_val_1_bismark_bt2_pe.bismark.cov,controls,chr15,89787335,89787335,0.0,0,37,37
SRR25023042_1_val_1_bismark_bt2_pe.bismark.cov,controls,chr17,41277106,41277106,0.0,0,299,299
SRR25023042_1_val_1_bismark_bt2_pe.bismark.cov,controls,chr17,41277115,41277115,0.668896321070234,2,297,299
SRR25023042_1_val_1_bismark_bt2_pe.bismark.cov,controls,chr17,41277117,41277117,0.668896321070234,2,297,299
SRR25023042_1_val_1_bismark_bt2_pe.bismark.cov,controls,chr17,41277153,41277153,0.337837837837838,1,295,296
SRR25023042_1_val_1_bismark_bt2_pe.bismark.cov,controls,chr17,41277160,41277160,0.677966101694915,2,293,295
SRR25023042_1_val_1_bismark_bt2_pe.bismark.cov,controls,chr17,41277174,41277174,1.67224080267559,5,294,299
SRR25023042_1_val_1_bismark_bt2_pe.bismark.cov,controls,chr17,41277187,41277187,3.68098159509202,6,157,163
SRR25023042_1_val_1_bismark_bt2_pe.bismark.cov,controls,chr17,41277214,41277214,1.32890365448505,4,297,301
SRR25023042_1_val_1_bismark_bt2_pe.bismark.cov,controls,chr17,41277232,41277232,0.332225913621262,1,300,301
SRR25023042_1_val_1_bismark_bt2_pe.bismark.cov,controls,chr17,56769746,56769746,83.8709677419355,26,5,31
SRR25023042_1_val_1_bismark_bt2_pe.bismark.cov,controls,chr17,56769760,56769760,74.1935483870968,23,8,31
SRR25023042_1_val_1_bismark_bt2_pe.bismark.cov,controls,chr17,56769767,56769767,48.3870967741936,15,16,31
SRR25023042_1_val_1_bismark_bt2_pe.bismark.cov,controls,chr17,56769830,56769830,3.2258064516129,1,30,31
SRR25023042_1_val_1_bismark_bt2_pe.bismark.cov,controls,chr17,56769866,56769866,3.125,1,31,32
SRR25023042_1_val_1_bismark_bt2_pe.bismark.cov,controls,chr17,56769883,56769883,0.0,0,32,32
SRR25023042_1_val_1_bismark_bt2_pe.bismark.cov,controls,chr17,56769891,56769891,3.125,1,31,32
SRR25023042_1_val_1_bismark_bt2_pe.bismark.cov,controls,chr17,56769895,56769895,0.0,0,32,32
SRR25023042_1_val_1_bismark_bt2_pe.bismark.cov,controls,chr17,56769904,56769904,3.125,1,31,32
SRR25023042_1_val_1_bismark_bt2_pe.bismark.cov,controls,chr17,56769912,56769912,0.0,0,31,31
SRR25023042_1_val_1_bismark_bt2_pe.bismark.cov,controls,chr17,56769922,56769922,0.0,0,29,29
SRR25023042_1_val_1_bismark_bt2_pe.bismark.cov,controls,chr17,56769929,56769929,0.0,0,27,27
SRR25023042_1_val_1_bismark_bt2_pe.bismark.cov,controls,chr17,56769936,56769936,0.0,0,27,27
SRR25023042_1_val_1_bismark_bt2_pe.bismark.cov,controls,chr17,56769941,56769941,0.0,0,24,24
SRR25023042_1_val_1_bismark_bt2_pe.bismark.cov,controls,chr17,56769944,56769944,0.0,0,24,24
SRR25023042_1_val_1_bismark_bt2_pe.bismark.cov,controls,chr17,56769948,56769948,0.0,0,22,22
SRR25023042_1_val_1_bismark_bt2_pe.bismark.cov,controls,chr17,56769956,56769956,0.0,0,21,21
SRR25023042_1_val_1_bismark_bt2_pe.bismark.cov,controls,chr17,56769982,56769982,0.0,0,25,25
SRR25023042_1_val_1_bismark_bt2_pe.bismark.cov,controls,chr17,56770003,56770003,0.0,0,29,29
SRR25023042_1_val_1_bismark_bt2_pe.bismark.cov,controls,chr17,56770008,56770008,0.0,0,30,30
SRR25023042_1_val_1_bismark_bt2_pe.bismark.cov,controls,chr17,56770010,56770010,0.0,0,31,31
SRR25023042_1_val_1_bismark_bt2_pe.bismark.cov,controls,chr17,56770018,56770018,3.125,1,31,32
SRR25023042_1_val_1_bismark_bt2_pe.bismark.cov,controls,chr17,56770023,56770023,3.03030303030303,1,32,33
SRR25023042_1_val_1_bismark_bt2_pe.bismark.cov,controls,chr17,56770038,56770038,0.0,0,32,32
SRR25023042_1_val_1_bismark_bt2_pe.bismark.cov,controls,chr17,56770057,56770057,0.0,0,33,33
SRR25023042_1_val_1_bismark_bt2_pe.bismark.cov,controls,chr17,56770069,56770069,0.0,0,33,33
SRR25023042_1_val_1_bismark_bt2_pe.bismark.cov,controls,chr17,56770074,56770074,0.0,0,33,33
SRR25023042_1_val_1_bismark_bt2_pe.bismark.cov,controls,chr17,56770093,56770093,0.0,0,33,33
SRR25023042_1_val_1_bismark_bt2_pe.bismark.cov,controls,chr17,59940970,59940970,0.754716981132076,8,1052,1060
SRR25023042_1_val_1_bismark_bt2_pe.bismark.cov,controls,chr17,59940975,59940975,0.188857412653447,2,1057,1059
SRR25023042_1_val_1_bismark_bt2_pe.bismark.cov,controls,chr17,59940988,59940988,0.48030739673391,5,1036,1041
SRR25023042_1_val_1_bismark_bt2_pe.bismark.cov,controls,chr17,59940997,59940997,0.979325353645267,9,910,919
SRR25023042_1_val_1_bismark_bt2_pe.bismark.cov,controls,chr17,59941017,59941017,0.269541778975741,2,740,742
SRR25023042_1_val_1_bismark_bt2_pe.bismark.cov,controls,chr17,59941051,59941051,0.210526315789474,2,948,950
SRR25023042_1_val_1_bismark_bt2_pe.bismark.cov,controls,chr17,59941053,59941053,0.48780487804878,5,1020,1025
SRR25023042_1_val_1_bismark_bt2_pe.bismark.cov,controls,chr17,59941056,59941056,1.12704918032787,11,965,976
SRR25023042_1_val_1_bismark_bt2_pe.bismark.cov,controls,chr17,59941067,59941067,0.807265388496468,8,983,991
SRR25023042_1_val_1_bismark_bt2_pe.bismark.cov,controls,chr17,59941110,59941110,0.826446280991736,9,1080,1089
SRR25023042_1_val_1_bismark_bt2_pe.bismark.cov,controls,chr17,59941133,59941133,1.28087831655993,14,1079,1093
SRR25023042_1_val_1_bismark_bt2_pe.bismark.cov,controls,chr17,59941136,59941136,0.457875457875458,5,1087,1092
SRR25023042_1_val_1_bismark_bt2_pe.bismark.cov,controls,chr17,59941187,59941187,0.455788514129444,5,1092,1097
SRR25023042_1_val_1_bismark_bt2_pe.bismark.cov,controls,chr17,59941191,59941191,0.998185117967332,11,1091,1102
SRR25023042_1_val_1_bismark_bt2_pe.bismark.cov,controls,chr17,59941201,59941201,0.636132315521628,5,781,786
SRR25023042_1_val_1_bismark_bt2_pe.bismark.cov,controls,chr17,59941202,59941202,0.738007380073801,2,269,271
SRR25023042_1_val_1_bismark_bt2_pe.bismark.cov,controls,chr22,29137950,29137950,0.0,0,39,39
SRR25023042_1_val_1_bismark_bt2_pe.bismark.cov,controls,chr22,29137964,29137964,0.0,0,27,27
SRR25023042_1_val_1_bismark_bt2_pe.bismark.cov,controls,chr22,29137975,29137975,0.0,0,21,21
SRR25023042_1_val_1_bismark_bt2_pe.bismark.cov,controls,chr22,29138052,29138052,0.0,0,28,28
SRR25023042_1_val_1_bismark_bt2_pe.bismark.cov,controls,chr22,29138062,29138062,0.0,0,33,33
SRR25023042_1_val_1_bismark_bt2_pe.bismark.cov,controls,chr22,29138075,29138075,0.0,0,37,37
SRR25023042_1_val_1_bismark_bt2_pe.bismark.cov,controls,chr22,29138078,29138078,0.0,0,38,38
SRR25023042_1_val_1_bismark_bt2_pe.bismark.cov,controls,chr22,29138091,29138091,0.0,0,33,33
SRR25023042_1_val_1_bismark_bt2_pe.bismark.cov,controls,chr22,29138102,29138102,0.0,0,41,41
SRR25023042_1_val_1_bismark_bt2_pe.bismark.cov,controls,chr22,29138115,29138115,0.0,0,40,40
SRR25023042_1_val_1_bismark_bt2_pe.bismark.cov,controls,chr22,29138134,29138134,0.0,0,40,40
SRR25023042_1_val_1_bismark_bt2_pe.bismark.cov,controls,chr22,29138158,29138158,0.0,0,40,40
SRR25023042_1_val_1_bismark_bt2_pe.bismark.cov,controls,chr22,29138168,29138168,0.0,0,40,40
SRR25023042_1_val_1_bismark_bt2_pe.bismark.cov,controls,chr22,29138176,29138176,0.0,0,40,40
SRR25023042_1_val_1_bismark_bt2_pe.bismark.cov,controls,chr22,29138179,29138179,0.0,0,40,40
SRR25023042_1_val_1_bismark_bt2_pe.bismark.cov,controls,chr22,29138185,29138185,2.5,1,39,40
SRR25023042_1_val_1_bismark_bt2_pe.bismark.cov,controls,chr22,29138202,29138202,0.0,0,40,40
SRR25023042_1_val_1_bismark_bt2_pe.bismark.cov,controls,chr22,29138216,29138216,2.5,1,39,40
SRR25023042_1_val_1_bismark_bt2_pe.bismark.cov,controls,chr22,29138219,29138219,2.56410256410256,1,38,39
SRR25023042_1_val_1_bismark_bt2_pe.bismark.cov,controls,chr22,29138234,29138234,0.0,0,38,38
SRR25023042_1_val_1_bismark_bt2_pe.bismark.cov,controls,chr22,29138238,29138238,0.0,0,38,38
SRR25023042_1_val_1_bismark_bt2_pe.bismark.cov,controls,chr16,23652769,23652769,0.253807106598985,1,393,394
SRR25023042_1_val_1_bismark_bt2_pe.bismark.cov,controls,chr16,23652783,23652783,0.255754475703325,1,390,391
SRR25023042_1_val_1_bismark_bt2_pe.bismark.cov,controls,chr16,23652787,23652787,0.769230769230769,3,387,390
SRR25023042_1_val_1_bismark_bt2_pe.bismark.cov,controls,chr16,23652797,23652797,0.519480519480519,2,383,385
SRR25023042_1_val_1_bismark_bt2_pe.bismark.cov,controls,chr16,23652818,23652818,1.34408602150538,5,367,372
SRR25023042_1_val_1_bismark_bt2_pe.bismark.cov,controls,chr16,23652838,23652838,0.0,0,377,377
SRR25023042_1_val_1_bismark_bt2_pe.bismark.cov,controls,chr16,23652857,23652857,0.510204081632653,2,390,392
SRR25023042_1_val_1_bismark_bt2_pe.bismark.cov,controls,chr16,23652860,23652860,0.51150895140665,2,389,391
SRR25023042_1_val_1_bismark_bt2_pe.bismark.cov,controls,chr16,23652876,23652876,1.52671755725191,6,387,393
SRR25023042_1_val_1_bismark_bt2_pe.bismark.cov,controls,chr16,23652906,23652906,0.255102040816327,1,391,392
SRR25023042_1_val_1_bismark_bt2_pe.bismark.cov,controls,chr16,23652911,23652911,0.510204081632653,2,390,392
SRR25023042_1_val_1_bismark_bt2_pe.bismark.cov,controls,chr16,23652916,23652916,0.0,0,391,391
SRR25023042_1_val_1_bismark_bt2_pe.bismark.cov,controls,chr16,23652918,23652918,0.512820512820513,2,388,390
SRR25023042_1_val_1_bismark_bt2_pe.bismark.cov,controls,chr7,6048869,6048869,0.371333085777943,10,2683,2693
SRR25023042_1_val_1_bismark_bt2_pe.bismark.cov,controls,chr7,6048876,6048876,0.743770918557084,20,2669,2689
SRR25023042_1_val_1_bismark_bt2_pe.bismark.cov,controls,chr7,6048884,6048884,0.372162262746558,10,2677,2687
SRR25023042_1_val_1_bismark_bt2_pe.bismark.cov,controls,chr7,6048888,6048888,0.672645739910314,18,2658,2676
SRR25023042_1_val_1_bismark_bt2_pe.bismark.cov,controls,chr7,6048892,6048892,0.670890793887439,18,2665,2683
SRR25023042_1_val_1_bismark_bt2_pe.bismark.cov,controls,chr7,6048904,6048904,0.190114068441065,1,525,526
SRR25023042_1_val_1_bismark_bt2_pe.bismark.cov,controls,chr7,6048918,6048918,0.558035714285714,15,2673,2688
SRR25023042_1_val_1_bismark_bt2_pe.bismark.cov,controls,chr7,6048925,6048925,0.483451097062105,13,2676,2689
SRR25023042_1_val_1_bismark_bt2_pe.bismark.cov,controls,chr7,6048928,6048928,0.780669144981413,21,2669,2690
SRR25023042_1_val_1_bismark_bt2_pe.bismark.cov,controls,chr7,6048940,6048940,0.669144981412639,18,2672,2690
SRR25023042_1_val_1_bismark_bt2_pe.bismark.cov,controls,chr7,6048951,6048951,0.854700854700855,23,2668,2691
SRR25023042_1_val_1_bismark_bt2_pe.bismark.cov,controls,chr7,6048966,6048966,0.668647845468053,18,2674,2692
SRR25023042_1_val_1_bismark_bt2_pe.bismark.cov,controls,chr7,6048968,6048968,0.819672131147541,22,2662,2684
SRR25023043_1_val_1_bismark_bt2_pe.bismark.cov,controls,chr3,37034307,37034307,100.0,2269,0,2269
SRR25023043_1_val_1_bismark_bt2_pe.bismark.cov,controls,chr3,37034316,37034316,0.528867342441604,12,2257,2269
SRR25023043_1_val_1_bismark_bt2_pe.bismark.cov,controls,chr3,37034324,37034324,0.485436893203883,11,2255,2266
SRR25023043_1_val_1_bismark_bt2_pe.bismark.cov,controls,chr3,37034330,37034330,0.573698146513681,13,2253,2266
SRR25023043_1_val_1_bismark_bt2_pe.bismark.cov,controls,chr3,37034344,37034344,0.751547303271441,17,2245,2262
SRR25023043_1_val_1_bismark_bt2_pe.bismark.cov,controls,chr3,37034346,37034346,0.486080424215643,11,2252,2263
SRR25023043_1_val_1_bismark_bt2_pe.bismark.cov,controls,chr3,37034348,37034348,0.529333921482135,12,2255,2267
SRR25023043_1_val_1_bismark_bt2_pe.bismark.cov,controls,chr3,37034352,37034352,0.750220653133274,17,2249,2266
SRR25023043_1_val_1_bismark_bt2_pe.bismark.cov,controls,chr3,37034355,37034355,1.10229276895944,25,2243,2268
SRR25023043_1_val_1_bismark_bt2_pe.bismark.cov,controls,chr3,37034359,37034359,0.706401766004415,16,2249,2265
SRR25023043_1_val_1_bismark_bt2_pe.bismark.cov,controls,chr3,37034369,37034369,1.01455668284076,23,2244,2267
SRR25023043_1_val_1_bismark_bt2_pe.bismark.cov,controls,chr3,37034373,37034373,0.618101545253863,14,2251,2265
SRR25023043_1_val_1_bismark_bt2_pe.bismark.cov,controls,chr3,37034382,37034382,0.39647577092511,9,2261,2270
SRR25023043_1_val_1_bismark_bt2_pe.bismark.cov,controls,chr3,37034394,37034394,0.220555800617556,5,2262,2267
SRR25023043_1_val_1_bismark_bt2_pe.bismark.cov,controls,chr3,37034402,37034402,0.794701986754967,18,2247,2265
SRR25023043_1_val_1_bismark_bt2_pe.bismark.cov,controls,chr3,37034409,37034409,0.529100529100529,12,2256,2268
SRR25023043_1_val_1_bismark_bt2_pe.bismark.cov,controls,chr3,37034412,37034412,1.01500441306267,23,2243,2266
SRR25023043_1_val_1_bismark_bt2_pe.bismark.cov,controls,chr3,37034414,37034414,0.749559082892416,17,2251,2268
SRR25023043_1_val_1_bismark_bt2_pe.bismark.cov,controls,chr3,37034418,37034418,0.88339222614841,20,2244,2264
SRR25023043_1_val_1_bismark_bt2_pe.bismark.cov,controls,chr3,37034420,37034420,0.70577856197618,16,2251,2267
SRR25023043_1_val_1_bismark_bt2_pe.bismark.cov,controls,chr3,37034430,37034430,0.529567519858782,12,2254,2266
SRR25023043_1_val_1_bismark_bt2_pe.bismark.cov,controls,chr3,37034438,37034438,0.353045013239188,8,2258,2266
SRR25023043_1_val_1_bismark_bt2_pe.bismark.cov,controls,chr3,37034441,37034441,0.617283950617284,14,2254,2268
SRR25023043_1_val_1_bismark_bt2_pe.bismark.cov,controls,chr3,37034466,37034466,99.9559082892416,2267,1,2268
SRR25023043_1_val_1_bismark_bt2_pe.bismark.cov,controls,chr3,37034997,37034997,0.879765395894428,18,2028,2046
SRR25023043_1_val_1_bismark_bt2_pe.bismark.cov,controls,chr3,37035012,37035012,0.587371512481645,12,2031,2043
SRR25023043_1_val_1_bismark_bt2_pe.bismark.cov,controls,chr3,37035032,37035032,0.294695481335953,6,2030,2036
SRR25023043_1_val_1_bismark_bt2_pe.bismark.cov,controls,chr3,37035043,37035043,0.588812561334642,12,2026,2038
SRR25023043_1_val_1_bismark_bt2_pe.bismark.cov,controls,chr3,37035047,37035047,0.196078431372549,4,2036,2040
SRR25023043_1_val_1_bismark_bt2_pe.bismark.cov,controls,chr3,37035063,37035063,0.490918016691213,10,2027,2037
SRR25023043_1_val_1_bismark_bt2_pe.bismark.cov,controls,chr3,37035066,37035066,0.588235294117647,12,2028,2040
SRR25023043_1_val_1_bismark_bt2_pe.bismark.cov,controls,chr3,37035074,37035074,0.53921568627451,11,2029,2040
SRR25023043_1_val_1_bismark_bt2_pe.bismark.cov,controls,chr3,37035090,37035090,0.490436488474743,10,2029,2039
SRR25023043_1_val_1_bismark_bt2_pe.bismark.cov,controls,chr3,37035095,37035095,0.392156862745098,8,2032,2040
SRR25023043_1_val_1_bismark_bt2_pe.bismark.cov,controls,chr3,37035097,37035097,0.587659157688541,12,2030,2042
SRR25023043_1_val_1_bismark_bt2_pe.bismark.cov,controls,chr3,37035100,37035100,0.441609421000981,9,2029,2038
SRR25023043_1_val_1_bismark_bt2_pe.bismark.cov,controls,chr3,37035117,37035117,1.02840352595495,21,2021,2042
SRR25023043_1_val_1_bismark_bt2_pe.bismark.cov,controls,chr3,142297977,142297977,0.518134715025907,1,192,193
SRR25023043_1_val_1_bismark_bt2_pe.bismark.cov,controls,chr3,142298019,142298019,1.04166666666667,2,190,192
SRR25023043_1_val_1_bismark_bt2_pe.bismark.cov,controls,chr3,142298045,142298045,0.518134715025907,1,192,193
SRR25023043_1_val_1_bismark_bt2_pe.bismark.cov,controls,chr3,142298054,142298054,5.23560209424084,10,181,191
SRR25023043_1_val_1_bismark_bt2_pe.bismark.cov,controls,chr2,47596828,47596828,3.02534750613246,37,1186,1223
SRR25023043_1_val_1_bismark_bt2_pe.bismark.cov,controls,chr2,47596830,47596830,4.82420278004906,59,1164,1223
SRR25023043_1_val_1_bismark_bt2_pe.bismark.cov,controls,chr2,47596840,47596840,3.50162866449511,43,1185,1228
SRR25023043_1_val_1_bismark_bt2_pe.bismark.cov,controls,chr2,47596849,47596849,17.6854115729421,217,1010,1227
SRR25023043_1_val_1_bismark_bt2_pe.bismark.cov,controls,chr2,47596853,47596853,7.09046454767726,87,1140,1227
SRR25023043_1_val_1_bismark_bt2_pe.bismark.cov,controls,chr2,47596858,47596858,9.63265306122449,118,1107,1225
SRR25023043_1_val_1_bismark_bt2_pe.bismark.cov,controls,chr2,47596862,47596862,7.24755700325733,89,1139,1228
SRR25023043_1_val_1_bismark_bt2_pe.bismark.cov,controls,chr2,47596869,47596869,19.0048939641109,233,993,1226
SRR25023043_1_val_1_bismark_bt2_pe.bismark.cov,controls,chr2,47596883,47596883,13.9591836734694,171,1054,1225
SRR25023043_1_val_1_bismark_bt2_pe.bismark.cov,controls,chr2,47596885,47596885,4.73856209150327,58,1166,1224
SRR25023043_1_val_1_bismark_bt2_pe.bismark.cov,controls,chr2,47596887,47596887,6.43322475570033,79,1149,1228
SRR25023043_1_val_1_bismark_bt2_pe.bismark.cov,controls,chr2,47596897,47596897,4.97147514262429,61,1166,1227
SRR25023043_1_val_1_bismark_bt2_pe.bismark.cov,controls,chr2,47596900,47596900,5.06122448979592,62,1163,1225
SRR25023043_1_val_1_bismark_bt2_pe.bismark.cov,controls,chr2,47596907,47596907,2.45098039215686,30,1194,1224
SRR25023043_1_val_1_bismark_bt2_pe.bismark.cov,controls,chr2,47596912,47596912,3.18627450980392,39,1185,1224
SRR25023043_1_val_1_bismark_bt2_pe.bismark.cov,controls,chr2,47596930,47596930,5.87275693311582,72,1154,1226
SRR25023043_1_val_1_bismark_bt2_pe.bismark.cov,controls,chr2,47596942,47596942,5.44272948822096,67,1164,1231
SRR25023043_1_val_1_bismark_bt2_pe.bismark.cov,controls,chr2,47630224,47630224,0.581395348837209,3,513,516
SRR25023043_1_val_1_bismark_bt2_pe.bismark.cov,controls,chr2,47630227,47630227,1.35396518375242,7,510,517
SRR25023043_1_val_1_bismark_bt2_pe.bismark.cov,controls,chr2,47630233,47630233,1.3671875,7,505,512
SRR25023043_1_val_1_bismark_bt2_pe.bismark.cov,controls,chr2,47630237,47630237,0.775193798449612,4,512,516
SRR25023043_1_val_1_bismark_bt2_pe.bismark.cov,controls,chr2,47630240,47630240,0.58252427184466,3,512,515
SRR25023043_1_val_1_bismark_bt2_pe.bismark.cov,controls,chr2,47630244,47630244,1.74418604651163,9,507,516
SRR25023043_1_val_1_bismark_bt2_pe.bismark.cov,controls,chr2,47630251,47630251,0.193423597678917,1,516,517
SRR25023043_1_val_1_bismark_bt2_pe.bismark.cov,controls,chr2,47630265,47630265,0.193798449612403,1,515,516
SRR25023043_1_val_1_bismark_bt2_pe.bismark.cov,controls,chr2,47630292,47630292,0.778210116731518,4,510,514
SRR25023043_1_val_1_bismark_bt2_pe.bismark.cov,controls,chr2,47630294,47630294,0.58252427184466,3,512,515
SRR25023043_1_val_1_bismark_bt2_pe.bismark.cov,controls,chr2,58468506,58468506,1.0,1,99,100
SRR25023043_1_val_1_bismark_bt2_pe.bismark.cov,controls,chr2,58468513,58468513,0.0,0,99,99
SRR25023043_1_val_1_bismark_bt2_pe.bismark.cov,controls,chr2,58468519,58468519,0.0,0,99,99
SRR25023043_1_val_1_bismark_bt2_pe.bismark.cov,controls,chr2,58468523,58468523,0.0,0,97,97
SRR25023043_1_val_1_bismark_bt2_pe.bismark.cov,controls,chr2,58468527,58468527,0.0,0,99,99
SRR25023043_1_val_1_bismark_bt2_pe.bismark.cov,controls,chr2,58468530,58468530,2.08333333333333,2,94,96
SRR25023043_1_val_1_bismark_bt2_pe.bismark.cov,controls,chr2,58468532,58468532,0.0,0,93,93
SRR25023043_1_val_1_bismark_bt2_pe.bismark.cov,controls,chr2,58468537,58468537,0.0,0,94,94
SRR25023043_1_val_1_bismark_bt2_pe.bismark.cov,controls,chr2,58468555,58468555,0.0,0,89,89
SRR25023043_1_val_1_bismark_bt2_pe.bismark.cov,controls,chr2,58468576,58468576,0.0,0,84,84
SRR25023043_1_val_1_bismark_bt2_pe.bismark.cov,controls,chr2,58468578,58468578,1.20481927710843,1,82,83
SRR25023043_1_val_1_bismark_bt2_pe.bismark.cov,controls,chr2,58468582,58468582,0.0,0,84,84
SRR25023043_1_val_1_bismark_bt2_pe.bismark.cov,controls,chr2,58468599,58468599,1.26582278481013,1,78,79
SRR25023043_1_val_1_bismark_bt2_pe.bismark.cov,controls,chr2,58468618,58468618,3.57142857142857,2,54,56
SRR25023043_1_val_1_bismark_bt2_pe.bismark.cov,controls,chr2,58468625,58468625,0.0,0,46,46
SRR25023043_1_val_1_bismark_bt2_pe.bismark.cov,controls,chr2,58468632,58468632,2.0,1,49,50
SRR25023043_1_val_1_bismark_bt2_pe.bismark.cov,controls,chr2,58468652,58468652,1.33333333333333,1,74,75
SRR25023043_1_val_1_bismark_bt2_pe.bismark.cov,controls,chr2,58468737,58468737,4.04040404040404,4,95,99
SRR25023043_1_val_1_bismark_bt2_pe.bismark.cov,controls,chr2,58468823,58468823,1.02040816326531,1,97,98
SRR25023043_1_val_1_bismark_bt2_pe.bismark.cov,controls,chr2,128051674,128051674,0.0,0,51,51
SRR25023043_1_val_1_bismark_bt2_pe.bismark.cov,controls,chr2,128051690,128051690,1.03092783505155,2,192,194
SRR25023043_1_val_1_bismark_bt2_pe.bismark.cov,controls,chr2,128051704,128051704,0.512820512820513,1,194,195
SRR25023043_1_val_1_bismark_bt2_pe.bismark.cov,controls,chr2,128051707,128051707,0.515463917525773,1,193,194
SRR25023043_1_val_1_bismark_bt2_pe.bismark.cov,controls,chr2,128051709,128051709,0.512820512820513,1,194,195
SRR25023043_1_val_1_bismark_bt2_pe.bismark.cov,controls,chr2,128051716,128051716,1.03092783505155,2,192,194
SRR25023043_1_val_1_bismark_bt2_pe.bismark.cov,controls,chr2,128051733,128051733,1.54639175257732,3,191,194
SRR25023043_1_val_1_bismark_bt2_pe.bismark.cov,controls,chr2,128051743,128051743,0.0,0,196,196
SRR25023043_1_val_1_bismark_bt2_pe.bismark.cov,controls,chr14,45604787,45604787,1.06007067137809,3,280,283
SRR25023043_1_val_1_bismark_bt2_pe.bismark.cov,controls,chr14,45604794,45604794,1.40845070422535,4,280,284
SRR25023043_1_val_1_bismark_bt2_pe.bismark.cov,controls,chr15,89786999,89786999,0.0,0,67,67
SRR25023043_1_val_1_bismark_bt2_pe.bismark.cov,controls,chr15,89787007,89787007,0.0,0,67,67
SRR25023043_1_val_1_bismark_bt2_pe.bismark.cov,controls,chr15,89787009,89787009,0.0,0,67,67
SRR25023043_1_val_1_bismark_bt2_pe.bismark.cov,controls,chr15,89787018,89787018,0.0,0,67,67
SRR25023043_1_val_1_bismark_bt2_pe.bismark.cov,controls,chr15,89787032,89787032,1.49253731343284,1,66,67
SRR25023043_1_val_1_bismark_bt2_pe.bismark.cov,controls,chr15,89787034,89787034,0.0,0,68,68
SRR25023043_1_val_1_bismark_bt2_pe.bismark.cov,controls,chr15,89787036,89787036,0.0,0,68,68
SRR25023043_1_val_1_bismark_bt2_pe.bismark.cov,controls,chr15,89787045,89787045,0.0,0,68,68
SRR25023043_1_val_1_bismark_bt2_pe.bismark.cov,controls,chr15,89787048,89787048,0.0,0,68,68
SRR25023043_1_val_1_bismark_bt2_pe.bismark.cov,controls,chr15,89787058,89787058,0.0,0,67,67
SRR25023043_1_val_1_bismark_bt2_pe.bismark.cov,controls,chr15,89787060,89787060,0.0,0,67,67
SRR25023043_1_val_1_bismark_bt2_pe.bismark.cov,controls,chr15,89787066,89787066,0.0,0,66,66
SRR25023043_1_val_1_bismark_bt2_pe.bismark.cov,controls,chr15,89787077,89787077,0.0,0,66,66
SRR25023043_1_val_1_bismark_bt2_pe.bismark.cov,controls,chr15,89787087,89787087,0.0,0,64,64
SRR25023043_1_val_1_bismark_bt2_pe.bismark.cov,controls,chr15,89787103,89787103,0.0,0,63,63
SRR25023043_1_val_1_bismark_bt2_pe.bismark.cov,controls,chr15,89787109,89787109,0.0,0,59,59
SRR25023043_1_val_1_bismark_bt2_pe.bismark.cov,controls,chr15,89787113,89787113,0.0,0,63,63
SRR25023043_1_val_1_bismark_bt2_pe.bismark.cov,controls,chr15,89787120,89787120,0.0,0,63,63
SRR25023043_1_val_1_bismark_bt2_pe.bismark.cov,controls,chr15,89787150,89787150,0.0,0,57,57
SRR25023043_1_val_1_bismark_bt2_pe.bismark.cov,controls,chr15,89787154,89787154,1.85185185185185,1,53,54
SRR25023043_1_val_1_bismark_bt2_pe.bismark.cov,controls,chr15,89787164,89787164,0.0,0,51,51
SRR25023043_1_val_1_bismark_bt2_pe.bismark.cov,controls,chr15,89787168,89787168,0.0,0,50,50
SRR25023043_1_val_1_bismark_bt2_pe.bismark.cov,controls,chr15,89787171,89787171,2.04081632653061,1,48,49
SRR25023043_1_val_1_bismark_bt2_pe.bismark.cov,controls,chr15,89787182,89787182,2.56410256410256,1,38,39
SRR25023043_1_val_1_bismark_bt2_pe.bismark.cov,controls,chr15,89787184,89787184,0.0,0,39,39
SRR25023043_1_val_1_bismark_bt2_pe.bismark.cov,controls,chr15,89787190,89787190,0.0,0,36,36
SRR25023043_1_val_1_bismark_bt2_pe.bismark.cov,controls,chr15,89787226,89787226,0.0,0,21,21
SRR25023043_1_val_1_bismark_bt2_pe.bismark.cov,controls,chr15,89787238,89787238,0.0,0,27,27
SRR25023043_1_val_1_bismark_bt2_pe.bismark.cov,controls,chr15,89787260,89787260,3.33333333333333,1,29,30
SRR25023043_1_val_1_bismark_bt2_pe.bismark.cov,controls,chr15,89787272,89787272,0.0,0,31,31
SRR25023043_1_val_1_bismark_bt2_pe.bismark.cov,controls,chr15,89787288,89787288,0.0,0,46,46
SRR25023043_1_val_1_bismark_bt2_pe.bismark.cov,controls,chr15,89787293,89787293,1.92307692307692,1,51,52
SRR25023043_1_val_1_bismark_bt2_pe.bismark.cov,controls,chr15,89787295,89787295,0.0,0,53,53
SRR25023043_1_val_1_bismark_bt2_pe.bismark.cov,controls,chr15,89787304,89787304,0.0,0,55,55
SRR25023043_1_val_1_bismark_bt2_pe.bismark.cov,controls,chr15,89787335,89787335,1.63934426229508,1,60,61
SRR25023043_1_val_1_bismark_bt2_pe.bismark.cov,controls,chr13,32889392,32889392,14.9191444966093,286,1631,1917
SRR25023043_1_val_1_bismark_bt2_pe.bismark.cov,controls,chr13,32889434,32889434,2.19206680584551,42,1874,1916
SRR25023043_1_val_1_bismark_bt2_pe.bismark.cov,controls,chr13,32889461,32889461,0.574412532637076,11,1904,1915
SRR25023043_1_val_1_bismark_bt2_pe.bismark.cov,controls,chr13,32889470,32889470,0.469238790406674,9,1909,1918
SRR25023043_1_val_1_bismark_bt2_pe.bismark.cov,controls,chr13,32889484,32889484,0.365344467640919,7,1909,1916
SRR25023043_1_val_1_bismark_bt2_pe.bismark.cov,controls,chr6,43543548,43543548,1.11856823266219,5,442,447
SRR25023043_1_val_1_bismark_bt2_pe.bismark.cov,controls,chr6,43543554,43543554,0.0,0,447,447
SRR25023043_1_val_1_bismark_bt2_pe.bismark.cov,controls,chr6,43543571,43543571,0.90293453724605,4,439,443
SRR25023043_1_val_1_bismark_bt2_pe.bismark.cov,controls,chr6,43543578,43543578,0.225225225225225,1,443,444
SRR25023043_1_val_1_bismark_bt2_pe.bismark.cov,controls,chr6,43543580,43543580,1.12866817155756,5,438,443
SRR25023043_1_val_1_bismark_bt2_pe.bismark.cov,controls,chr6,43543596,43543596,0.45045045045045,2,442,444
SRR25023043_1_val_1_bismark_bt2_pe.bismark.cov,controls,chr6,43543608,43543608,0.449438202247191,2,443,445
SRR25023043_1_val_1_bismark_bt2_pe.bismark.cov,controls,chr6,43543613,43543613,2.02247191011236,9,436,445
SRR25023043_1_val_1_bismark_bt2_pe.bismark.cov,controls,chr6,43543615,43543615,1.79775280898876,8,437,445
SRR25023043_1_val_1_bismark_bt2_pe.bismark.cov,controls,chr6,43543618,43543618,0.680272108843537,3,438,441
SRR25023043_1_val_1_bismark_bt2_pe.bismark.cov,controls,chr6,43543624,43543624,0.225225225225225,1,443,444
SRR25023043_1_val_1_bismark_bt2_pe.bismark.cov,controls,chr6,43543642,43543642,0.451467268623025,2,441,443
SRR25023043_1_val_1_bismark_bt2_pe.bismark.cov,controls,chr6,43543650,43543650,0.22883295194508,1,436,437
SRR25023043_1_val_1_bismark_bt2_pe.bismark.cov,controls,chr6,43543657,43543657,1.38248847926267,6,428,434
SRR25023043_1_val_1_bismark_bt2_pe.bismark.cov,controls,chr6,43543669,43543669,0.233644859813084,1,427,428
SRR25023043_1_val_1_bismark_bt2_pe.bismark.cov,controls,chr6,43543672,43543672,0.0,0,426,426
SRR25023043_1_val_1_bismark_bt2_pe.bismark.cov,controls,chr6,43543682,43543682,2.35849056603774,10,414,424
SRR25023043_1_val_1_bismark_bt2_pe.bismark.cov,controls,chr6,43543691,43543691,0.954653937947494,4,415,419
SRR25023043_1_val_1_bismark_bt2_pe.bismark.cov,controls,chr6,43543696,43543696,4.31654676258993,18,399,417
SRR25023043_1_val_1_bismark_bt2_pe.bismark.cov,controls,chr6,43543698,43543698,0.239808153477218,1,416,417
SRR25023043_1_val_1_bismark_bt2_pe.bismark.cov,controls,chr6,43543701,43543701,4.36893203883495,18,394,412
SRR25023043_1_val_1_bismark_bt2_pe.bismark.cov,controls,chr6,43543705,43543705,0.244498777506112,1,408,409
SRR25023043_1_val_1_bismark_bt2_pe.bismark.cov,controls,chr6,43543708,43543708,0.245700245700246,1,406,407
SRR25023043_1_val_1_bismark_bt2_pe.bismark.cov,controls,chr6,43543733,43543733,0.819672131147541,3,363,366
SRR25023043_1_val_1_bismark_bt2_pe.bismark.cov,controls,chr6,43543747,43543747,3.50404312668464,13,358,371
SRR25023043_1_val_1_bismark_bt2_pe.bismark.cov,controls,chr6,43543749,43543749,1.06100795755968,4,373,377
SRR25023043_1_val_1_bismark_bt2_pe.bismark.cov,controls,chr6,43543763,43543763,1.0958904109589,4,361,365
SRR25023043_1_val_1_bismark_bt2_pe.bismark.cov,controls,chr6,43543766,43543766,0.552486187845304,2,360,362
SRR25023043_1_val_1_bismark_bt2_pe.bismark.cov,controls,chr6,43543771,43543771,0.274725274725275,1,363,364
SRR25023043_1_val_1_bismark_bt2_pe.bismark.cov,controls,chr6,43543775,43543775,0.819672131147541,3,363,366
SRR25023043_1_val_1_bismark_bt2_pe.bismark.cov,controls,chr6,43543777,43543777,1.0840108401084,4,365,369
SRR25023043_1_val_1_bismark_bt2_pe.bismark.cov,controls,chr6,43543781,43543781,0.531914893617021,2,374,376
SRR25023043_1_val_1_bismark_bt2_pe.bismark.cov,controls,chr6,43543786,43543786,0.537634408602151,2,370,372
SRR25023043_1_val_1_bismark_bt2_pe.bismark.cov,controls,chr6,43543794,43543794,0.253807106598985,1,393,394
SRR25023043_1_val_1_bismark_bt2_pe.bismark.cov,controls,chr6,43543798,43543798,3.05343511450382,12,381,393
SRR25023043_1_val_1_bismark_bt2_pe.bismark.cov,controls,chr6,43543800,43543800,1.26903553299492,5,389,394
SRR25023043_1_val_1_bismark_bt2_pe.bismark.cov,controls,chr6,43543804,43543804,1.99004975124378,8,394,402
SRR25023043_1_val_1_bismark_bt2_pe.bismark.cov,controls,chr6,43543806,43543806,0.496277915632754,2,401,403
SRR25023043_1_val_1_bismark_bt2_pe.bismark.cov,controls,chr6,43543815,43543815,0.481927710843374,2,413,415
SRR25023043_1_val_1_bismark_bt2_pe.bismark.cov,controls,chr6,43543822,43543822,0.471698113207547,2,422,424
SRR25023043_1_val_1_bismark_bt2_pe.bismark.cov,controls,chr10,89619506,89619506,99.5594713656388,226,1,227
SRR25023043_1_val_1_bismark_bt2_pe.bismark.cov,controls,chr10,89619510,89619510,98.6784140969163,224,3,227
SRR25023043_1_val_1_bismark_bt2_pe.bismark.cov,controls,chr10,89619512,89619512,98.2378854625551,223,4,227
SRR25023043_1_val_1_bismark_bt2_pe.bismark.cov,controls,chr10,89619522,89619522,98.2378854625551,223,4,227
SRR25023043_1_val_1_bismark_bt2_pe.bismark.cov,controls,chr10,89619550,89619550,96.9162995594714,220,7,227
SRR25023043_1_val_1_bismark_bt2_pe.bismark.cov,controls,chr10,89619555,89619555,100.0,226,0,226
SRR25023043_1_val_1_bismark_bt2_pe.bismark.cov,controls,chr10,89619566,89619566,96.4601769911504,218,8,226
SRR25023043_1_val_1_bismark_bt2_pe.bismark.cov,controls,chr10,89619580,89619580,92.9515418502203,211,16,227
SRR25023043_1_val_1_bismark_bt2_pe.bismark.cov,controls,chr11,22647545,22647545,0.0,0,41,41
SRR25023043_1_val_1_bismark_bt2_pe.bismark.cov,controls,chr11,22647600,22647600,0.0,0,32,32
SRR25023043_1_val_1_bismark_bt2_pe.bismark.cov,controls,chr11,22647610,22647610,0.0,0,31,31
SRR25023043_1_val_1_bismark_bt2_pe.bismark.cov,controls,chr11,22647618,22647618,0.0,0,28,28
SRR25023043_1_val_1_bismark_bt2_pe.bismark.cov,controls,chr11,22647622,22647622,0.0,0,28,28
SRR25023043_1_val_1_bismark_bt2_pe.bismark.cov,controls,chr11,22647649,22647649,0.0,0,21,21
SRR25023043_1_val_1_bismark_bt2_pe.bismark.cov,controls,chr11,22647651,22647651,0.0,0,22,22
SRR25023043_1_val_1_bismark_bt2_pe.bismark.cov,controls,chr11,22647661,22647661,0.0,0,26,26
SRR25023043_1_val_1_bismark_bt2_pe.bismark.cov,controls,chr11,22647745,22647745,0.0,0,45,45
SRR25023043_1_val_1_bismark_bt2_pe.bismark.cov,controls,chr11,22647764,22647764,8.88888888888889,4,41,45
SRR25023043_1_val_1_bismark_bt2_pe.bismark.cov,controls,chr11,22647774,22647774,0.0,0,44,44
SRR25023043_1_val_1_bismark_bt2_pe.bismark.cov,controls,chr11,22647849,22647849,82.2222222222222,37,8,45
SRR25023043_1_val_1_bismark_bt2_pe.bismark.cov,controls,chr11,108093323,108093323,0.0,0,122,122
SRR25023043_1_val_1_bismark_bt2_pe.bismark.cov,controls,chr11,108093335,108093335,1.63934426229508,2,120,122
SRR25023043_1_val_1_bismark_bt2_pe.bismark.cov,controls,chr11,108093338,108093338,0.0,0,121,121
SRR25023043_1_val_1_bismark_bt2_pe.bismark.cov,controls,chr11,108093359,108093359,0.0,0,119,119
SRR25023043_1_val_1_bismark_bt2_pe.bismark.cov,controls,chr11,108093371,108093371,0.0,0,100,100
SRR25023043_1_val_1_bismark_bt2_pe.bismark.cov,controls,chr11,108093373,108093373,0.0,0,101,101
SRR25023043_1_val_1_bismark_bt2_pe.bismark.cov,controls,chr11,108093386,108093386,0.0,0,101,101
SRR25023043_1_val_1_bismark_bt2_pe.bismark.cov,controls,chr11,108093395,108093395,0.99009900990099,1,100,101
SRR25023043_1_val_1_bismark_bt2_pe.bismark.cov,controls,chr11,108093402,108093402,0.0,0,101,101
SRR25023043_1_val_1_bismark_bt2_pe.bismark.cov,controls,chr11,108093413,108093413,0.0,0,101,101
SRR25023043_1_val_1_bismark_bt2_pe.bismark.cov,controls,chr11,108093419,108093419,1.98019801980198,2,99,101
SRR25023043_1_val_1_bismark_bt2_pe.bismark.cov,controls,chr11,108093436,108093436,1.01010101010101,1,98,99
SRR25023043_1_val_1_bismark_bt2_pe.bismark.cov,controls,chr11,108093439,108093439,0.0,0,100,100
SRR25023043_1_val_1_bismark_bt2_pe.bismark.cov,controls,chr11,108093451,108093451,1.01010101010101,1,98,99
SRR25023043_1_val_1_bismark_bt2_pe.bismark.cov,controls,chr11,108093457,108093457,1.02040816326531,1,97,98
SRR25023043_1_val_1_bismark_bt2_pe.bismark.cov,controls,chr11,108093461,108093461,1.02040816326531,1,97,98
SRR25023043_1_val_1_bismark_bt2_pe.bismark.cov,controls,chr11,108093467,108093467,0.0,0,97,97
SRR25023043_1_val_1_bismark_bt2_pe.bismark.cov,controls,chr11,108093476,108093476,0.0,0,84,84
SRR25023043_1_val_1_bismark_bt2_pe.bismark.cov,controls,chr11,108093485,108093485,0.0,0,73,73
SRR25023043_1_val_1_bismark_bt2_pe.bismark.cov,controls,chr11,108093505,108093505,2.4390243902439,1,40,41
SRR25023043_1_val_1_bismark_bt2_pe.bismark.cov,controls,chr11,108093520,108093520,4.0,1,24,25
SRR25023043_1_val_1_bismark_bt2_pe.bismark.cov,controls,chr11,108093560,108093560,2.73972602739726,2,71,73
SRR25023043_1_val_1_bismark_bt2_pe.bismark.cov,controls,chr11,108093567,108093567,1.25,1,79,80
SRR25023043_1_val_1_bismark_bt2_pe.bismark.cov,controls,chr11,108093572,108093572,0.0,0,84,84
SRR25023043_1_val_1_bismark_bt2_pe.bismark.cov,controls,chr11,108093579,108093579,0.0,0,86,86
SRR25023043_1_val_1_bismark_bt2_pe.bismark.cov,controls,chr11,108093584,108093584,1.11111111111111,1,89,90
SRR25023043_1_val_1_bismark_bt2_pe.bismark.cov,controls,chr11,108093590,108093590,1.02040816326531,1,97,98
SRR25023043_1_val_1_bismark_bt2_pe.bismark.cov,controls,chr11,108093598,108093598,0.0,0,99,99
SRR25023043_1_val_1_bismark_bt2_pe.bismark.cov,controls,chr17,41277106,41277106,1.35593220338983,4,291,295
SRR25023043_1_val_1_bismark_bt2_pe.bismark.cov,controls,chr17,41277115,41277115,0.0,0,297,297
SRR25023043_1_val_1_bismark_bt2_pe.bismark.cov,controls,chr17,41277117,41277117,2.7027027027027,8,288,296
SRR25023043_1_val_1_bismark_bt2_pe.bismark.cov,controls,chr17,41277153,41277153,1.02389078498294,3,290,293
SRR25023043_1_val_1_bismark_bt2_pe.bismark.cov,controls,chr17,41277160,41277160,0.338983050847458,1,294,295
SRR25023043_1_val_1_bismark_bt2_pe.bismark.cov,controls,chr17,41277174,41277174,0.673400673400673,2,295,297
SRR25023043_1_val_1_bismark_bt2_pe.bismark.cov,controls,chr17,41277214,41277214,0.664451827242525,2,299,301
SRR25023043_1_val_1_bismark_bt2_pe.bismark.cov,controls,chr17,41277232,41277232,0.996677740863787,3,298,301
SRR25023043_1_val_1_bismark_bt2_pe.bismark.cov,controls,chr17,56769746,56769746,90.7407407407407,49,5,54
SRR25023043_1_val_1_bismark_bt2_pe.bismark.cov,controls,chr17,56769760,56769760,89.4736842105263,51,6,57
SRR25023043_1_val_1_bismark_bt2_pe.bismark.cov,controls,chr17,56769767,56769767,82.4561403508772,47,10,57
SRR25023043_1_val_1_bismark_bt2_pe.bismark.cov,controls,chr17,56769830,56769830,1.63934426229508,1,60,61
SRR25023043_1_val_1_bismark_bt2_pe.bismark.cov,controls,chr17,56769866,56769866,4.91803278688525,3,58,61
SRR25023043_1_val_1_bismark_bt2_pe.bismark.cov,controls,chr17,56769883,56769883,0.0,0,61,61
SRR25023043_1_val_1_bismark_bt2_pe.bismark.cov,controls,chr17,56769891,56769891,0.0,0,61,61
SRR25023043_1_val_1_bismark_bt2_pe.bismark.cov,controls,chr17,56769895,56769895,0.0,0,60,60
SRR25023043_1_val_1_bismark_bt2_pe.bismark.cov,controls,chr17,56769904,56769904,0.0,0,62,62
SRR25023043_1_val_1_bismark_bt2_pe.bismark.cov,controls,chr17,56769912,56769912,0.0,0,61,61
SRR25023043_1_val_1_bismark_bt2_pe.bismark.cov,controls,chr17,56769922,56769922,1.66666666666667,1,59,60
SRR25023043_1_val_1_bismark_bt2_pe.bismark.cov,controls,chr17,56769929,56769929,1.75438596491228,1,56,57
SRR25023043_1_val_1_bismark_bt2_pe.bismark.cov,controls,chr17,56769936,56769936,0.0,0,55,55
SRR25023043_1_val_1_bismark_bt2_pe.bismark.cov,controls,chr17,56769941,56769941,0.0,0,48,48
SRR25023043_1_val_1_bismark_bt2_pe.bismark.cov,controls,chr17,56769944,56769944,0.0,0,47,47
SRR25023043_1_val_1_bismark_bt2_pe.bismark.cov,controls,chr17,56769948,56769948,0.0,0,40,40
SRR25023043_1_val_1_bismark_bt2_pe.bismark.cov,controls,chr17,56769956,56769956,5.71428571428571,2,33,35
SRR25023043_1_val_1_bismark_bt2_pe.bismark.cov,controls,chr17,56769962,56769962,0.0,0,26,26
SRR25023043_1_val_1_bismark_bt2_pe.bismark.cov,controls,chr17,56769966,56769966,0.0,0,23,23
SRR25023043_1_val_1_bismark_bt2_pe.bismark.cov,controls,chr17,56769982,56769982,2.4390243902439,1,40,41
SRR25023043_1_val_1_bismark_bt2_pe.bismark.cov,controls,chr17,56770003,56770003,0.0,0,52,52
SRR25023043_1_val_1_bismark_bt2_pe.bismark.cov,controls,chr17,56770008,56770008,0.0,0,52,52
SRR25023043_1_val_1_bismark_bt2_pe.bismark.cov,controls,chr17,56770010,56770010,0.0,0,52,52
SRR25023043_1_val_1_bismark_bt2_pe.bismark.cov,controls,chr17,56770018,56770018,0.0,0,56,56
SRR25023043_1_val_1_bismark_bt2_pe.bismark.cov,controls,chr17,56770023,56770023,1.78571428571429,1,55,56
SRR25023043_1_val_1_bismark_bt2_pe.bismark.cov,controls,chr17,56770038,56770038,1.75438596491228,1,56,57
SRR25023043_1_val_1_bismark_bt2_pe.bismark.cov,controls,chr17,56770057,56770057,1.66666666666667,1,59,60
SRR25023043_1_val_1_bismark_bt2_pe.bismark.cov,controls,chr17,56770069,56770069,1.66666666666667,1,59,60
SRR25023043_1_val_1_bismark_bt2_pe.bismark.cov,controls,chr17,56770074,56770074,0.0,0,60,60
SRR25023043_1_val_1_bismark_bt2_pe.bismark.cov,controls,chr17,56770093,56770093,0.0,0,61,61
SRR25023043_1_val_1_bismark_bt2_pe.bismark.cov,controls,chr17,59940970,59940970,0.30188679245283,4,1321,1325
SRR25023043_1_val_1_bismark_bt2_pe.bismark.cov,controls,chr17,59940975,59940975,0.377643504531722,5,1319,1324
SRR25023043_1_val_1_bismark_bt2_pe.bismark.cov,controls,chr17,59940988,59940988,0.844854070660522,11,1291,1302
SRR25023043_1_val_1_bismark_bt2_pe.bismark.cov,controls,chr17,59940997,59940997,0.5249343832021,6,1137,1143
SRR25023043_1_val_1_bismark_bt2_pe.bismark.cov,controls,chr17,59941017,59941017,0.685602350636631,7,1014,1021
SRR25023043_1_val_1_bismark_bt2_pe.bismark.cov,controls,chr17,59941051,59941051,0.414250207125104,5,1202,1207
SRR25023043_1_val_1_bismark_bt2_pe.bismark.cov,controls,chr17,59941053,59941053,0.91533180778032,12,1299,1311
SRR25023043_1_val_1_bismark_bt2_pe.bismark.cov,controls,chr17,59941056,59941056,0.32599837000815,4,1223,1227
SRR25023043_1_val_1_bismark_bt2_pe.bismark.cov,controls,chr17,59941067,59941067,0.0803212851405622,1,1244,1245
SRR25023043_1_val_1_bismark_bt2_pe.bismark.cov,controls,chr17,59941110,59941110,0.144196106705119,2,1385,1387
SRR25023043_1_val_1_bismark_bt2_pe.bismark.cov,controls,chr17,59941133,59941133,0.502873563218391,7,1385,1392
SRR25023043_1_val_1_bismark_bt2_pe.bismark.cov,controls,chr17,59941136,59941136,0.648882480173035,9,1378,1387
SRR25023043_1_val_1_bismark_bt2_pe.bismark.cov,controls,chr17,59941187,59941187,0.357653791130186,5,1393,1398
SRR25023043_1_val_1_bismark_bt2_pe.bismark.cov,controls,chr17,59941191,59941191,0.713266761768902,10,1392,1402
SRR25023043_1_val_1_bismark_bt2_pe.bismark.cov,controls,chr17,59941201,59941201,1.28458498023715,13,999,1012
SRR25023043_1_val_1_bismark_bt2_pe.bismark.cov,controls,chr17,59941202,59941202,0.0,0,328,328
SRR25023043_1_val_1_bismark_bt2_pe.bismark.cov,controls,chr7,6048869,6048869,0.462351387054161,14,3014,3028
SRR25023043_1_val_1_bismark_bt2_pe.bismark.cov,controls,chr7,6048876,6048876,0.596026490066225,18,3002,3020
SRR25023043_1_val_1_bismark_bt2_pe.bismark.cov,controls,chr7,6048884,6048884,0.630391506303915,19,2995,3014
SRR25023043_1_val_1_bismark_bt2_pe.bismark.cov,controls,chr7,6048888,6048888,0.765645805592543,23,2981,3004
SRR25023043_1_val_1_bismark_bt2_pe.bismark.cov,controls,chr7,6048892,6048892,0.365084633255891,11,3002,3013
SRR25023043_1_val_1_bismark_bt2_pe.bismark.cov,controls,chr7,6048904,6048904,0.0,0,585,585
SRR25023043_1_val_1_bismark_bt2_pe.bismark.cov,controls,chr7,6048918,6048918,0.23194168323393,7,3011,3018
SRR25023043_1_val_1_bismark_bt2_pe.bismark.cov,controls,chr7,6048925,6048925,0.331895121141719,10,3003,3013
SRR25023043_1_val_1_bismark_bt2_pe.bismark.cov,controls,chr7,6048928,6048928,0.72992700729927,22,2992,3014
SRR25023043_1_val_1_bismark_bt2_pe.bismark.cov,controls,chr7,6048940,6048940,0.497182631753397,15,3002,3017
SRR25023043_1_val_1_bismark_bt2_pe.bismark.cov,controls,chr7,6048951,6048951,0.298111957601855,9,3010,3019
SRR25023043_1_val_1_bismark_bt2_pe.bismark.cov,controls,chr7,6048966,6048966,0.561241333773523,17,3012,3029
SRR25023043_1_val_1_bismark_bt2_pe.bismark.cov,controls,chr7,6048968,6048968,0.397614314115308,12,3006,3018
SRR25023043_1_val_1_bismark_bt2_pe.bismark.cov,controls,chr16,23652769,23652769,0.442477876106195,2,450,452
SRR25023043_1_val_1_bismark_bt2_pe.bismark.cov,controls,chr16,23652783,23652783,1.54525386313466,7,446,453
SRR25023043_1_val_1_bismark_bt2_pe.bismark.cov,controls,chr16,23652787,23652787,0.884955752212389,4,448,452
SRR25023043_1_val_1_bismark_bt2_pe.bismark.cov,controls,chr16,23652797,23652797,0.669642857142857,3,445,448
SRR25023043_1_val_1_bismark_bt2_pe.bismark.cov,controls,chr16,23652818,23652818,0.681818181818182,3,437,440
SRR25023043_1_val_1_bismark_bt2_pe.bismark.cov,controls,chr16,23652838,23652838,0.227790432801822,1,438,439
SRR25023043_1_val_1_bismark_bt2_pe.bismark.cov,controls,chr16,23652857,23652857,0.221238938053097,1,451,452
SRR25023043_1_val_1_bismark_bt2_pe.bismark.cov,controls,chr16,23652860,23652860,0.663716814159292,3,449,452
SRR25023043_1_val_1_bismark_bt2_pe.bismark.cov,controls,chr16,23652876,23652876,0.221238938053097,1,451,452
SRR25023043_1_val_1_bismark_bt2_pe.bismark.cov,controls,chr16,23652906,23652906,0.0,0,453,453
SRR25023043_1_val_1_bismark_bt2_pe.bismark.cov,controls,chr16,23652911,23652911,0.66079295154185,3,451,454
SRR25023043_1_val_1_bismark_bt2_pe.bismark.cov,controls,chr16,23652916,23652916,0.66079295154185,3,451,454
SRR25023043_1_val_1_bismark_bt2_pe.bismark.cov,controls,chr16,23652918,23652918,0.0,0,453,453
SRR25023043_1_val_1_bismark_bt2_pe.bismark.cov,controls,chr22,29137950,29137950,0.0,0,83,83
SRR25023043_1_val_1_bismark_bt2_pe.bismark.cov,controls,chr22,29137964,29137964,0.0,0,78,78
SRR25023043_1_val_1_bismark_bt2_pe.bismark.cov,controls,chr22,29137975,29137975,0.0,0,69,69
SRR25023043_1_val_1_bismark_bt2_pe.bismark.cov,controls,chr22,29137985,29137985,0.0,0,53,53
SRR25023043_1_val_1_bismark_bt2_pe.bismark.cov,controls,chr22,29137993,29137993,2.12765957446809,1,46,47
SRR25023043_1_val_1_bismark_bt2_pe.bismark.cov,controls,chr22,29138031,29138031,0.0,0,36,36
SRR25023043_1_val_1_bismark_bt2_pe.bismark.cov,controls,chr22,29138052,29138052,0.0,0,55,55
SRR25023043_1_val_1_bismark_bt2_pe.bismark.cov,controls,chr22,29138062,29138062,0.0,0,62,62
SRR25023043_1_val_1_bismark_bt2_pe.bismark.cov,controls,chr22,29138075,29138075,0.0,0,67,67
SRR25023043_1_val_1_bismark_bt2_pe.bismark.cov,controls,chr22,29138078,29138078,0.0,0,74,74
SRR25023043_1_val_1_bismark_bt2_pe.bismark.cov,controls,chr22,29138091,29138091,0.0,0,76,76
SRR25023043_1_val_1_bismark_bt2_pe.bismark.cov,controls,chr22,29138102,29138102,0.0,0,84,84
SRR25023043_1_val_1_bismark_bt2_pe.bismark.cov,controls,chr22,29138115,29138115,0.0,0,84,84
SRR25023043_1_val_1_bismark_bt2_pe.bismark.cov,controls,chr22,29138134,29138134,1.17647058823529,1,84,85
SRR25023043_1_val_1_bismark_bt2_pe.bismark.cov,controls,chr22,29138158,29138158,1.16279069767442,1,85,86
SRR25023043_1_val_1_bismark_bt2_pe.bismark.cov,controls,chr22,29138168,29138168,0.0,0,86,86
SRR25023043_1_val_1_bismark_bt2_pe.bismark.cov,controls,chr22,29138176,29138176,0.0,0,87,87
SRR25023043_1_val_1_bismark_bt2_pe.bismark.cov,controls,chr22,29138179,29138179,2.29885057471264,2,85,87
SRR25023043_1_val_1_bismark_bt2_pe.bismark.cov,controls,chr22,29138185,29138185,4.54545454545455,4,84,88
SRR25023043_1_val_1_bismark_bt2_pe.bismark.cov,controls,chr22,29138202,29138202,1.13636363636364,1,87,88
SRR25023043_1_val_1_bismark_bt2_pe.bismark.cov,controls,chr22,29138216,29138216,1.14942528735632,1,86,87
SRR25023043_1_val_1_bismark_bt2_pe.bismark.cov,controls,chr22,29138219,29138219,1.14942528735632,1,86,87
SRR25023043_1_val_1_bismark_bt2_pe.bismark.cov,controls,chr22,29138234,29138234,0.0,0,87,87
SRR25023043_1_val_1_bismark_bt2_pe.bismark.cov,controls,chr22,29138238,29138238,1.17647058823529,1,84,85
SRR25023301_1_val_1_bismark_bt2_pe.bismark.cov,cases,chr13,32889392,32889392,14.010067114094,501,3075,3576
SRR25023301_1_val_1_bismark_bt2_pe.bismark.cov,cases,chr13,32889434,32889434,2.21040850587577,79,3495,3574
SRR25023301_1_val_1_bismark_bt2_pe.bismark.cov,cases,chr13,32889461,32889461,1.25979843225084,45,3527,3572
SRR25023301_1_val_1_bismark_bt2_pe.bismark.cov,cases,chr13,32889470,32889470,0.587412587412587,21,3554,3575
SRR25023301_1_val_1_bismark_bt2_pe.bismark.cov,cases,chr13,32889484,32889484,0.392047045645477,14,3557,3571
SRR25023301_1_val_1_bismark_bt2_pe.bismark.cov,cases,chr13,108867034,108867034,47.1933471933472,454,508,962
SRR25023301_1_val_1_bismark_bt2_pe.bismark.cov,cases,chr13,108867044,108867044,60.3909465020576,587,385,972
SRR25023301_1_val_1_bismark_bt2_pe.bismark.cov,cases,chr13,108867051,108867051,49.4877049180328,483,493,976
SRR25023301_1_val_1_bismark_bt2_pe.bismark.cov,cases,chr13,108867109,108867109,88.0368098159509,861,117,978
SRR25023301_1_val_1_bismark_bt2_pe.bismark.cov,cases,chr13,108867112,108867112,87.1297242083759,853,126,979
SRR25023301_1_val_1_bismark_bt2_pe.bismark.cov,cases,chr13,108867124,108867124,76.0491299897646,743,234,977
SRR25023301_1_val_1_bismark_bt2_pe.bismark.cov,cases,chr13,108867135,108867135,62.2564102564103,607,368,975
SRR25023301_1_val_1_bismark_bt2_pe.bismark.cov,cases,chr13,108867155,108867155,61.1909650924025,596,378,974
SRR25023301_1_val_1_bismark_bt2_pe.bismark.cov,cases,chr3,37034307,37034307,99.9285714285714,2798,2,2800
SRR25023301_1_val_1_bismark_bt2_pe.bismark.cov,cases,chr3,37034316,37034316,0.286020736503396,8,2789,2797
SRR25023301_1_val_1_bismark_bt2_pe.bismark.cov,cases,chr3,37034324,37034324,0.322118826055834,9,2785,2794
SRR25023301_1_val_1_bismark_bt2_pe.bismark.cov,cases,chr3,37034330,37034330,0.178890876565295,5,2790,2795
SRR25023301_1_val_1_bismark_bt2_pe.bismark.cov,cases,chr3,37034344,37034344,0.966356478167502,27,2767,2794
SRR25023301_1_val_1_bismark_bt2_pe.bismark.cov,cases,chr3,37034346,37034346,0.393841747225206,11,2782,2793
SRR25023301_1_val_1_bismark_bt2_pe.bismark.cov,cases,chr3,37034348,37034348,0.502152080344333,14,2774,2788
SRR25023301_1_val_1_bismark_bt2_pe.bismark.cov,cases,chr3,37034352,37034352,0.286327845382963,8,2786,2794
SRR25023301_1_val_1_bismark_bt2_pe.bismark.cov,cases,chr3,37034355,37034355,0.393841747225206,11,2782,2793
SRR25023301_1_val_1_bismark_bt2_pe.bismark.cov,cases,chr3,37034359,37034359,0.465616045845272,13,2779,2792
SRR25023301_1_val_1_bismark_bt2_pe.bismark.cov,cases,chr3,37034369,37034369,1.39245144741664,38,2691,2729
SRR25023301_1_val_1_bismark_bt2_pe.bismark.cov,cases,chr3,37034373,37034373,0.572450805008945,16,2779,2795
SRR25023301_1_val_1_bismark_bt2_pe.bismark.cov,cases,chr3,37034382,37034382,0.286225402504472,8,2787,2795
SRR25023301_1_val_1_bismark_bt2_pe.bismark.cov,cases,chr3,37034394,37034394,0.107334525939177,3,2792,2795
SRR25023301_1_val_1_bismark_bt2_pe.bismark.cov,cases,chr3,37034402,37034402,0.429491768074445,12,2782,2794
SRR25023301_1_val_1_bismark_bt2_pe.bismark.cov,cases,chr3,37034409,37034409,0.643776824034335,18,2778,2796
SRR25023301_1_val_1_bismark_bt2_pe.bismark.cov,cases,chr3,37034412,37034412,0.680272108843537,19,2774,2793
SRR25023301_1_val_1_bismark_bt2_pe.bismark.cov,cases,chr3,37034414,37034414,0.716075904045829,20,2773,2793
SRR25023301_1_val_1_bismark_bt2_pe.bismark.cov,cases,chr3,37034418,37034418,0.572655690765927,16,2778,2794
SRR25023301_1_val_1_bismark_bt2_pe.bismark.cov,cases,chr3,37034420,37034420,0.715051841258491,20,2777,2797
SRR25023301_1_val_1_bismark_bt2_pe.bismark.cov,cases,chr3,37034430,37034430,0.429645542427497,12,2781,2793
SRR25023301_1_val_1_bismark_bt2_pe.bismark.cov,cases,chr3,37034438,37034438,0.464949928469242,13,2783,2796
SRR25023301_1_val_1_bismark_bt2_pe.bismark.cov,cases,chr3,37034441,37034441,0.214745884037223,6,2788,2794
SRR25023301_1_val_1_bismark_bt2_pe.bismark.cov,cases,chr3,37034466,37034466,99.8923573735199,2784,3,2787
SRR25023301_1_val_1_bismark_bt2_pe.bismark.cov,cases,chr3,37034997,37034997,0.643896976483763,23,3549,3572
SRR25023301_1_val_1_bismark_bt2_pe.bismark.cov,cases,chr3,37035012,37035012,0.503919372900336,18,3554,3572
SRR25023301_1_val_1_bismark_bt2_pe.bismark.cov,cases,chr3,37035032,37035032,0.784533482768282,28,3541,3569
SRR25023301_1_val_1_bismark_bt2_pe.bismark.cov,cases,chr3,37035043,37035043,0.224026883225987,8,3563,3571
SRR25023301_1_val_1_bismark_bt2_pe.bismark.cov,cases,chr3,37035047,37035047,0.392156862745098,14,3556,3570
SRR25023301_1_val_1_bismark_bt2_pe.bismark.cov,cases,chr3,37035063,37035063,0.531468531468531,19,3556,3575
SRR25023301_1_val_1_bismark_bt2_pe.bismark.cov,cases,chr3,37035066,37035066,1.00783874580067,36,3536,3572
SRR25023301_1_val_1_bismark_bt2_pe.bismark.cov,cases,chr3,37035074,37035074,0.476057126855223,17,3554,3571
SRR25023301_1_val_1_bismark_bt2_pe.bismark.cov,cases,chr3,37035090,37035090,1.11950741673664,40,3533,3573
SRR25023301_1_val_1_bismark_bt2_pe.bismark.cov,cases,chr3,37035095,37035095,0.447427293064877,16,3560,3576
SRR25023301_1_val_1_bismark_bt2_pe.bismark.cov,cases,chr3,37035097,37035097,0.867861142217245,31,3541,3572
SRR25023301_1_val_1_bismark_bt2_pe.bismark.cov,cases,chr3,37035100,37035100,0.531914893617021,19,3553,3572
SRR25023301_1_val_1_bismark_bt2_pe.bismark.cov,cases,chr3,37035117,37035117,0.392266741384141,14,3555,3569
SRR25023301_1_val_1_bismark_bt2_pe.bismark.cov,cases,chr3,142297977,142297977,1.30597014925373,14,1058,1072
SRR25023301_1_val_1_bismark_bt2_pe.bismark.cov,cases,chr3,142298019,142298019,1.02707749766573,11,1060,1071
SRR25023301_1_val_1_bismark_bt2_pe.bismark.cov,cases,chr3,142298045,142298045,1.21155638397018,13,1060,1073
SRR25023301_1_val_1_bismark_bt2_pe.bismark.cov,cases,chr3,142298054,142298054,3.55472404115996,38,1031,1069
SRR25023301_1_val_1_bismark_bt2_pe.bismark.cov,cases,chr14,45604787,45604787,0.536193029490617,2,371,373
SRR25023301_1_val_1_bismark_bt2_pe.bismark.cov,cases,chr14,45604794,45604794,0.268096514745308,1,372,373
SRR25023301_1_val_1_bismark_bt2_pe.bismark.cov,cases,chr2,47596828,47596828,8.55640535372849,179,1913,2092
SRR25023301_1_val_1_bismark_bt2_pe.bismark.cov,cases,chr2,47596830,47596830,8.38407494145199,179,1956,2135
SRR25023301_1_val_1_bismark_bt2_pe.bismark.cov,cases,chr2,47596840,47596840,10.4351895180159,223,1914,2137
SRR25023301_1_val_1_bismark_bt2_pe.bismark.cov,cases,chr2,47596849,47596849,33.9596054485674,723,1406,2129
SRR25023301_1_val_1_bismark_bt2_pe.bismark.cov,cases,chr2,47596853,47596853,19.2037470725995,410,1725,2135
SRR25023301_1_val_1_bismark_bt2_pe.bismark.cov,cases,chr2,47596858,47596858,20.6475832942281,440,1691,2131
SRR25023301_1_val_1_bismark_bt2_pe.bismark.cov,cases,chr2,47596862,47596862,20.3660253402159,434,1697,2131
SRR25023301_1_val_1_bismark_bt2_pe.bismark.cov,cases,chr2,47596869,47596869,31.288056206089,668,1467,2135
SRR25023301_1_val_1_bismark_bt2_pe.bismark.cov,cases,chr2,47596883,47596883,29.2235294117647,621,1504,2125
SRR25023301_1_val_1_bismark_bt2_pe.bismark.cov,cases,chr2,47596885,47596885,13.3239171374765,283,1841,2124
SRR25023301_1_val_1_bismark_bt2_pe.bismark.cov,cases,chr2,47596887,47596887,15.5472052606858,331,1798,2129
SRR25023301_1_val_1_bismark_bt2_pe.bismark.cov,cases,chr2,47596897,47596897,14.8235294117647,315,1810,2125
SRR25023301_1_val_1_bismark_bt2_pe.bismark.cov,cases,chr2,47596900,47596900,10.320452403393,219,1903,2122
SRR25023301_1_val_1_bismark_bt2_pe.bismark.cov,cases,chr2,47596907,47596907,9.55294117647059,203,1922,2125
SRR25023301_1_val_1_bismark_bt2_pe.bismark.cov,cases,chr2,47596912,47596912,9.68500235072873,206,1921,2127
SRR25023301_1_val_1_bismark_bt2_pe.bismark.cov,cases,chr2,47596930,47596930,10.9595484477893,233,1893,2126
SRR25023301_1_val_1_bismark_bt2_pe.bismark.cov,cases,chr2,47596942,47596942,13.8157894736842,294,1834,2128
SRR25023301_1_val_1_bismark_bt2_pe.bismark.cov,cases,chr2,47630224,47630224,1.10544217687075,13,1163,1176
SRR25023301_1_val_1_bismark_bt2_pe.bismark.cov,cases,chr2,47630227,47630227,1.15990057995029,14,1193,1207
SRR25023301_1_val_1_bismark_bt2_pe.bismark.cov,cases,chr2,47630233,47630233,0.497100248550124,6,1201,1207
SRR25023301_1_val_1_bismark_bt2_pe.bismark.cov,cases,chr2,47630237,47630237,0.580431177446103,7,1199,1206
SRR25023301_1_val_1_bismark_bt2_pe.bismark.cov,cases,chr2,47630240,47630240,0.994200497100249,12,1195,1207
SRR25023301_1_val_1_bismark_bt2_pe.bismark.cov,cases,chr2,47630244,47630244,0.745033112582781,9,1199,1208
SRR25023301_1_val_1_bismark_bt2_pe.bismark.cov,cases,chr2,47630251,47630251,0.993377483443709,12,1196,1208
SRR25023301_1_val_1_bismark_bt2_pe.bismark.cov,cases,chr2,47630265,47630265,0.912863070539419,11,1194,1205
SRR25023301_1_val_1_bismark_bt2_pe.bismark.cov,cases,chr2,47630292,47630292,0.413907284768212,5,1203,1208
SRR25023301_1_val_1_bismark_bt2_pe.bismark.cov,cases,chr2,47630294,47630294,0.827814569536424,10,1198,1208
SRR25023301_1_val_1_bismark_bt2_pe.bismark.cov,cases,chr2,128051674,128051674,0.485436893203883,1,205,206
SRR25023301_1_val_1_bismark_bt2_pe.bismark.cov,cases,chr2,128051690,128051690,0.75,6,794,800
SRR25023301_1_val_1_bismark_bt2_pe.bismark.cov,cases,chr2,128051704,128051704,0.875,7,793,800
SRR25023301_1_val_1_bismark_bt2_pe.bismark.cov,cases,chr2,128051707,128051707,0.624219725343321,5,796,801
SRR25023301_1_val_1_bismark_bt2_pe.bismark.cov,cases,chr2,128051709,128051709,0.998751560549313,8,793,801
SRR25023301_1_val_1_bismark_bt2_pe.bismark.cov,cases,chr2,128051716,128051716,0.249376558603491,2,800,802
SRR25023301_1_val_1_bismark_bt2_pe.bismark.cov,cases,chr2,128051733,128051733,0.374531835205993,3,798,801
SRR25023301_1_val_1_bismark_bt2_pe.bismark.cov,cases,chr2,128051743,128051743,0.875,7,793,800
SRR25023301_1_val_1_bismark_bt2_pe.bismark.cov,cases,chr2,178787742,178787742,84.2364532019704,342,64,406
SRR25023301_1_val_1_bismark_bt2_pe.bismark.cov,cases,chr10,89619506,89619506,97.6435935198822,1326,32,1358
SRR25023301_1_val_1_bismark_bt2_pe.bismark.cov,cases,chr10,89619510,89619510,97.7205882352941,1329,31,1360
SRR25023301_1_val_1_bismark_bt2_pe.bismark.cov,cases,chr10,89619512,89619512,98.3823529411765,1338,22,1360
SRR25023301_1_val_1_bismark_bt2_pe.bismark.cov,cases,chr10,89619522,89619522,97.0652971386647,1323,40,1363
SRR25023301_1_val_1_bismark_bt2_pe.bismark.cov,cases,chr10,89619550,89619550,97.3529411764706,1324,36,1360
SRR25023301_1_val_1_bismark_bt2_pe.bismark.cov,cases,chr10,89619555,89619555,97.7941176470588,1330,30,1360
SRR25023301_1_val_1_bismark_bt2_pe.bismark.cov,cases,chr10,89619566,89619566,95.2906548933039,1295,64,1359
SRR25023301_1_val_1_bismark_bt2_pe.bismark.cov,cases,chr10,89619580,89619580,93.2303164091244,1267,92,1359
SRR25023301_1_val_1_bismark_bt2_pe.bismark.cov,cases,chr11,108093323,108093323,1.00558659217877,9,886,895
SRR25023301_1_val_1_bismark_bt2_pe.bismark.cov,cases,chr11,108093335,108093335,0.7847533632287,7,885,892
SRR25023301_1_val_1_bismark_bt2_pe.bismark.cov,cases,chr11,108093338,108093338,0.112107623318386,1,891,892
SRR25023301_1_val_1_bismark_bt2_pe.bismark.cov,cases,chr11,108093359,108093359,0.458715596330275,4,868,872
SRR25023301_1_val_1_bismark_bt2_pe.bismark.cov,cases,chr11,108093371,108093371,0.0,0,686,686
SRR25023301_1_val_1_bismark_bt2_pe.bismark.cov,cases,chr11,108093373,108093373,0.291120815138282,2,685,687
SRR25023301_1_val_1_bismark_bt2_pe.bismark.cov,cases,chr11,108093386,108093386,0.726744186046512,5,683,688
SRR25023301_1_val_1_bismark_bt2_pe.bismark.cov,cases,chr11,108093395,108093395,0.291120815138282,2,685,687
SRR25023301_1_val_1_bismark_bt2_pe.bismark.cov,cases,chr11,108093402,108093402,0.0,0,683,683
SRR25023301_1_val_1_bismark_bt2_pe.bismark.cov,cases,chr11,108093413,108093413,0.29806259314456,2,669,671
SRR25023301_1_val_1_bismark_bt2_pe.bismark.cov,cases,chr11,108093419,108093419,1.1887072808321,8,665,673
SRR25023301_1_val_1_bismark_bt2_pe.bismark.cov,cases,chr11,108093436,108093436,0.149253731343284,1,669,670
SRR25023301_1_val_1_bismark_bt2_pe.bismark.cov,cases,chr11,108093439,108093439,1.94029850746269,13,657,670
SRR25023301_1_val_1_bismark_bt2_pe.bismark.cov,cases,chr11,108093451,108093451,1.34328358208955,9,661,670
SRR25023301_1_val_1_bismark_bt2_pe.bismark.cov,cases,chr11,108093457,108093457,1.49476831091181,10,659,669
SRR25023301_1_val_1_bismark_bt2_pe.bismark.cov,cases,chr11,108093461,108093461,0.449775112443778,3,664,667
SRR25023301_1_val_1_bismark_bt2_pe.bismark.cov,cases,chr11,108093467,108093467,0.449775112443778,3,664,667
SRR25023301_1_val_1_bismark_bt2_pe.bismark.cov,cases,chr11,108093476,108093476,1.05421686746988,7,657,664
SRR25023301_1_val_1_bismark_bt2_pe.bismark.cov,cases,chr11,108093485,108093485,0.455235204855842,3,656,659
SRR25023301_1_val_1_bismark_bt2_pe.bismark.cov,cases,chr11,108093505,108093505,0.646203554119548,4,615,619
SRR25023301_1_val_1_bismark_bt2_pe.bismark.cov,cases,chr11,108093520,108093520,0.773694390715667,4,513,517
SRR25023301_1_val_1_bismark_bt2_pe.bismark.cov,cases,chr11,108093529,108093529,0.0,0,27,27
SRR25023301_1_val_1_bismark_bt2_pe.bismark.cov,cases,chr11,108093532,108093532,0.0,0,26,26
SRR25023301_1_val_1_bismark_bt2_pe.bismark.cov,cases,chr11,108093538,108093538,0.0,0,39,39
SRR25023301_1_val_1_bismark_bt2_pe.bismark.cov,cases,chr11,108093560,108093560,0.18796992481203,1,531,532
SRR25023301_1_val_1_bismark_bt2_pe.bismark.cov,cases,chr11,108093567,108093567,1.3986013986014,8,564,572
SRR25023301_1_val_1_bismark_bt2_pe.bismark.cov,cases,chr11,108093572,108093572,1.19047619047619,7,581,588
SRR25023301_1_val_1_bismark_bt2_pe.bismark.cov,cases,chr11,108093579,108093579,0.826446280991736,5,600,605
SRR25023301_1_val_1_bismark_bt2_pe.bismark.cov,cases,chr11,108093584,108093584,0.161030595813205,1,620,621
SRR25023301_1_val_1_bismark_bt2_pe.bismark.cov,cases,chr11,108093590,108093590,0.152905198776758,1,653,654
SRR25023301_1_val_1_bismark_bt2_pe.bismark.cov,cases,chr11,108093598,108093598,0.298953662182362,2,667,669
SRR25023301_1_val_1_bismark_bt2_pe.bismark.cov,cases,chr8,30890012,30890012,68.5106382978723,161,74,235
SRR25023301_1_val_1_bismark_bt2_pe.bismark.cov,cases,chr8,30890034,30890034,72.1030042918455,168,65,233
SRR25023301_1_val_1_bismark_bt2_pe.bismark.cov,cases,chr8,30890051,30890051,96.0869565217391,221,9,230
SRR25023301_1_val_1_bismark_bt2_pe.bismark.cov,cases,chr8,30890057,30890057,82.7586206896552,192,40,232
SRR25023301_1_val_1_bismark_bt2_pe.bismark.cov,cases,chr8,30890073,30890073,54.5064377682403,127,106,233
SRR25023301_1_val_1_bismark_bt2_pe.bismark.cov,cases,chr8,30890108,30890108,24.5689655172414,57,175,232
SRR25023301_1_val_1_bismark_bt2_pe.bismark.cov,cases,chr8,30890133,30890133,32.6086956521739,75,155,230
SRR25023301_1_val_1_bismark_bt2_pe.bismark.cov,cases,chr8,30890139,30890139,52.1739130434783,120,110,230
SRR25023301_1_val_1_bismark_bt2_pe.bismark.cov,cases,chr8,30890145,30890145,18.2608695652174,42,188,230
SRR25023301_1_val_1_bismark_bt2_pe.bismark.cov,cases,chr8,30890170,30890170,18.2608695652174,42,188,230
SRR25023301_1_val_1_bismark_bt2_pe.bismark.cov,cases,chr8,30890172,30890172,20.8695652173913,48,182,230
SRR25023301_1_val_1_bismark_bt2_pe.bismark.cov,cases,chr8,90997245,90997245,16.2790697674419,14,72,86
SRR25023301_1_val_1_bismark_bt2_pe.bismark.cov,cases,chr8,90997299,90997299,3.79746835443038,3,76,79
SRR25023301_1_val_1_bismark_bt2_pe.bismark.cov,cases,chr8,90997454,90997454,35.1351351351351,26,48,74
SRR25023301_1_val_1_bismark_bt2_pe.bismark.cov,cases,chr8,90997482,90997482,98.6111111111111,71,1,72
SRR25023301_1_val_1_bismark_bt2_pe.bismark.cov,cases,chr15,89786999,89786999,1.25786163522013,4,314,318
SRR25023301_1_val_1_bismark_bt2_pe.bismark.cov,cases,chr15,89787007,89787007,0.928792569659443,3,320,323
SRR25023301_1_val_1_bismark_bt2_pe.bismark.cov,cases,chr15,89787009,89787009,1.23456790123457,4,320,324
SRR25023301_1_val_1_bismark_bt2_pe.bismark.cov,cases,chr15,89787018,89787018,0.617283950617284,2,322,324
SRR25023301_1_val_1_bismark_bt2_pe.bismark.cov,cases,chr15,89787032,89787032,0.925925925925926,3,321,324
SRR25023301_1_val_1_bismark_bt2_pe.bismark.cov,cases,chr15,89787034,89787034,0.617283950617284,2,322,324
SRR25023301_1_val_1_bismark_bt2_pe.bismark.cov,cases,chr15,89787036,89787036,0.308641975308642,1,323,324
SRR25023301_1_val_1_bismark_bt2_pe.bismark.cov,cases,chr15,89787045,89787045,0.31055900621118,1,321,322
SRR25023301_1_val_1_bismark_bt2_pe.bismark.cov,cases,chr15,89787048,89787048,0.93167701863354,3,319,322
SRR25023301_1_val_1_bismark_bt2_pe.bismark.cov,cases,chr15,89787058,89787058,0.625,2,318,320
SRR25023301_1_val_1_bismark_bt2_pe.bismark.cov,cases,chr15,89787060,89787060,0.3125,1,319,320
SRR25023301_1_val_1_bismark_bt2_pe.bismark.cov,cases,chr15,89787066,89787066,0.626959247648903,2,317,319
SRR25023301_1_val_1_bismark_bt2_pe.bismark.cov,cases,chr15,89787077,89787077,0.0,0,318,318
SRR25023301_1_val_1_bismark_bt2_pe.bismark.cov,cases,chr15,89787087,89787087,0.313479623824451,1,318,319
SRR25023301_1_val_1_bismark_bt2_pe.bismark.cov,cases,chr15,89787103,89787103,0.638977635782748,2,311,313
SRR25023301_1_val_1_bismark_bt2_pe.bismark.cov,cases,chr15,89787109,89787109,0.641025641025641,2,310,312
SRR25023301_1_val_1_bismark_bt2_pe.bismark.cov,cases,chr15,89787113,89787113,0.964630225080386,3,308,311
SRR25023301_1_val_1_bismark_bt2_pe.bismark.cov,cases,chr15,89787120,89787120,0.964630225080386,3,308,311
SRR25023301_1_val_1_bismark_bt2_pe.bismark.cov,cases,chr15,89787150,89787150,0.649350649350649,2,306,308
SRR25023301_1_val_1_bismark_bt2_pe.bismark.cov,cases,chr15,89787154,89787154,0.651465798045603,2,305,307
SRR25023301_1_val_1_bismark_bt2_pe.bismark.cov,cases,chr15,89787164,89787164,0.327868852459016,1,304,305
SRR25023301_1_val_1_bismark_bt2_pe.bismark.cov,cases,chr15,89787168,89787168,0.0,0,307,307
SRR25023301_1_val_1_bismark_bt2_pe.bismark.cov,cases,chr15,89787171,89787171,0.65359477124183,2,304,306
SRR25023301_1_val_1_bismark_bt2_pe.bismark.cov,cases,chr15,89787182,89787182,1.98019801980198,6,297,303
SRR25023301_1_val_1_bismark_bt2_pe.bismark.cov,cases,chr15,89787184,89787184,0.0,0,301,301
SRR25023301_1_val_1_bismark_bt2_pe.bismark.cov,cases,chr15,89787190,89787190,0.0,0,298,298
SRR25023301_1_val_1_bismark_bt2_pe.bismark.cov,cases,chr15,89787205,89787205,0.0,0,281,281
SRR25023301_1_val_1_bismark_bt2_pe.bismark.cov,cases,chr15,89787212,89787212,0.900900900900901,2,220,222
SRR25023301_1_val_1_bismark_bt2_pe.bismark.cov,cases,chr15,89787223,89787223,1.06951871657754,2,185,187
SRR25023301_1_val_1_bismark_bt2_pe.bismark.cov,cases,chr15,89787226,89787226,0.531914893617021,1,187,188
SRR25023301_1_val_1_bismark_bt2_pe.bismark.cov,cases,chr15,89787238,89787238,1.41509433962264,3,209,212
SRR25023301_1_val_1_bismark_bt2_pe.bismark.cov,cases,chr15,89787260,89787260,1.71673819742489,4,229,233
SRR25023301_1_val_1_bismark_bt2_pe.bismark.cov,cases,chr15,89787272,89787272,1.68067226890756,4,234,238
SRR25023301_1_val_1_bismark_bt2_pe.bismark.cov,cases,chr15,89787288,89787288,1.77304964539007,5,277,282
SRR25023301_1_val_1_bismark_bt2_pe.bismark.cov,cases,chr15,89787293,89787293,0.0,0,292,292
SRR25023301_1_val_1_bismark_bt2_pe.bismark.cov,cases,chr15,89787295,89787295,0.341296928327645,1,292,293
SRR25023301_1_val_1_bismark_bt2_pe.bismark.cov,cases,chr15,89787304,89787304,0.325732899022801,1,306,307
SRR25023301_1_val_1_bismark_bt2_pe.bismark.cov,cases,chr15,89787335,89787335,0.625,2,318,320
SRR25023301_1_val_1_bismark_bt2_pe.bismark.cov,cases,chr17,41277106,41277106,0.963000506842372,19,1954,1973
SRR25023301_1_val_1_bismark_bt2_pe.bismark.cov,cases,chr17,41277115,41277115,0.861195542046606,17,1957,1974
SRR25023301_1_val_1_bismark_bt2_pe.bismark.cov,cases,chr17,41277117,41277117,0.760263558033452,15,1958,1973
SRR25023301_1_val_1_bismark_bt2_pe.bismark.cov,cases,chr17,41277153,41277153,0.813008130081301,16,1952,1968
SRR25023301_1_val_1_bismark_bt2_pe.bismark.cov,cases,chr17,41277160,41277160,0.60882800608828,12,1959,1971
SRR25023301_1_val_1_bismark_bt2_pe.bismark.cov,cases,chr17,41277174,41277174,1.47133434804668,29,1942,1971
SRR25023301_1_val_1_bismark_bt2_pe.bismark.cov,cases,chr17,41277187,41277187,7.57128810226155,77,940,1017
SRR25023301_1_val_1_bismark_bt2_pe.bismark.cov,cases,chr17,41277214,41277214,0.958144225920323,19,1964,1983
SRR25023301_1_val_1_bismark_bt2_pe.bismark.cov,cases,chr17,41277232,41277232,0.654911838790932,13,1972,1985
SRR25023301_1_val_1_bismark_bt2_pe.bismark.cov,cases,chr17,56769746,56769746,83.0188679245283,132,27,159
SRR25023301_1_val_1_bismark_bt2_pe.bismark.cov,cases,chr17,56769760,56769760,84.9056603773585,135,24,159
SRR25023301_1_val_1_bismark_bt2_pe.bismark.cov,cases,chr17,56769767,56769767,70.0636942675159,110,47,157
SRR25023301_1_val_1_bismark_bt2_pe.bismark.cov,cases,chr17,56769830,56769830,0.641025641025641,1,155,156
SRR25023301_1_val_1_bismark_bt2_pe.bismark.cov,cases,chr17,56769866,56769866,1.29032258064516,2,153,155
SRR25023301_1_val_1_bismark_bt2_pe.bismark.cov,cases,chr17,56769883,56769883,0.0,0,153,153
SRR25023301_1_val_1_bismark_bt2_pe.bismark.cov,cases,chr17,56769891,56769891,0.65359477124183,1,152,153
SRR25023301_1_val_1_bismark_bt2_pe.bismark.cov,cases,chr17,56769895,56769895,0.0,0,152,152
SRR25023301_1_val_1_bismark_bt2_pe.bismark.cov,cases,chr17,56769904,56769904,0.0,0,152,152
SRR25023301_1_val_1_bismark_bt2_pe.bismark.cov,cases,chr17,56769912,56769912,1.31578947368421,2,150,152
SRR25023301_1_val_1_bismark_bt2_pe.bismark.cov,cases,chr17,56769922,56769922,1.32450331125828,2,149,151
SRR25023301_1_val_1_bismark_bt2_pe.bismark.cov,cases,chr17,56769929,56769929,0.0,0,151,151
SRR25023301_1_val_1_bismark_bt2_pe.bismark.cov,cases,chr17,56769936,56769936,0.0,0,151,151
SRR25023301_1_val_1_bismark_bt2_pe.bismark.cov,cases,chr17,56769941,56769941,0.0,0,151,151
SRR25023301_1_val_1_bismark_bt2_pe.bismark.cov,cases,chr17,56769944,56769944,0.666666666666667,1,149,150
SRR25023301_1_val_1_bismark_bt2_pe.bismark.cov,cases,chr17,56769948,56769948,0.675675675675676,1,147,148
SRR25023301_1_val_1_bismark_bt2_pe.bismark.cov,cases,chr17,56769956,56769956,0.719424460431655,1,138,139
SRR25023301_1_val_1_bismark_bt2_pe.bismark.cov,cases,chr17,56769962,56769962,0.75187969924812,1,132,133
SRR25023301_1_val_1_bismark_bt2_pe.bismark.cov,cases,chr17,56769966,56769966,0.769230769230769,1,129,130
SRR25023301_1_val_1_bismark_bt2_pe.bismark.cov,cases,chr17,56769982,56769982,0.740740740740741,1,134,135
SRR25023301_1_val_1_bismark_bt2_pe.bismark.cov,cases,chr17,56770003,56770003,0.0,0,145,145
SRR25023301_1_val_1_bismark_bt2_pe.bismark.cov,cases,chr17,56770008,56770008,0.684931506849315,1,145,146
SRR25023301_1_val_1_bismark_bt2_pe.bismark.cov,cases,chr17,56770010,56770010,1.36986301369863,2,144,146
SRR25023301_1_val_1_bismark_bt2_pe.bismark.cov,cases,chr17,56770018,56770018,0.0,0,146,146
SRR25023301_1_val_1_bismark_bt2_pe.bismark.cov,cases,chr17,56770023,56770023,1.36986301369863,2,144,146
SRR25023301_1_val_1_bismark_bt2_pe.bismark.cov,cases,chr17,56770038,56770038,2.04081632653061,3,144,147
SRR25023301_1_val_1_bismark_bt2_pe.bismark.cov,cases,chr17,56770057,56770057,0.666666666666667,1,149,150
SRR25023301_1_val_1_bismark_bt2_pe.bismark.cov,cases,chr17,56770069,56770069,1.98675496688742,3,148,151
SRR25023301_1_val_1_bismark_bt2_pe.bismark.cov,cases,chr17,56770074,56770074,0.662251655629139,1,150,151
SRR25023301_1_val_1_bismark_bt2_pe.bismark.cov,cases,chr17,56770093,56770093,0.0,0,151,151
SRR25023301_1_val_1_bismark_bt2_pe.bismark.cov,cases,chr17,59940970,59940970,0.429184549356223,2,464,466
SRR25023301_1_val_1_bismark_bt2_pe.bismark.cov,cases,chr17,59940975,59940975,0.21505376344086,1,464,465
SRR25023301_1_val_1_bismark_bt2_pe.bismark.cov,cases,chr17,59940988,59940988,0.216450216450216,1,461,462
SRR25023301_1_val_1_bismark_bt2_pe.bismark.cov,cases,chr17,59940997,59940997,0.442477876106195,2,450,452
SRR25023301_1_val_1_bismark_bt2_pe.bismark.cov,cases,chr17,59941017,59941017,0.0,0,261,261
SRR25023301_1_val_1_bismark_bt2_pe.bismark.cov,cases,chr17,59941051,59941051,0.216919739696312,1,460,461
SRR25023301_1_val_1_bismark_bt2_pe.bismark.cov,cases,chr17,59941053,59941053,2.19123505976096,11,491,502
SRR25023301_1_val_1_bismark_bt2_pe.bismark.cov,cases,chr17,59941056,59941056,0.435729847494553,2,457,459
SRR25023301_1_val_1_bismark_bt2_pe.bismark.cov,cases,chr17,59941067,59941067,0.212765957446809,1,469,470
SRR25023301_1_val_1_bismark_bt2_pe.bismark.cov,cases,chr17,59941110,59941110,0.190114068441065,1,525,526
SRR25023301_1_val_1_bismark_bt2_pe.bismark.cov,cases,chr17,59941133,59941133,0.568181818181818,3,525,528
SRR25023301_1_val_1_bismark_bt2_pe.bismark.cov,cases,chr17,59941136,59941136,0.760456273764259,4,522,526
SRR25023301_1_val_1_bismark_bt2_pe.bismark.cov,cases,chr17,59941187,59941187,0.378787878787879,2,526,528
SRR25023301_1_val_1_bismark_bt2_pe.bismark.cov,cases,chr17,59941191,59941191,0.378071833648393,2,527,529
SRR25023301_1_val_1_bismark_bt2_pe.bismark.cov,cases,chr17,59941201,59941201,1.51133501259446,6,391,397
SRR25023301_1_val_1_bismark_bt2_pe.bismark.cov,cases,chr17,59941202,59941202,0.0,0,116,116
SRR25023301_1_val_1_bismark_bt2_pe.bismark.cov,cases,chr17,76325846,76325846,48.5714285714286,17,18,35
SRR25023301_1_val_1_bismark_bt2_pe.bismark.cov,cases,chr17,76325851,76325851,25.7142857142857,9,26,35
SRR25023301_1_val_1_bismark_bt2_pe.bismark.cov,cases,chr17,76325865,76325865,17.1428571428571,6,29,35
SRR25023301_1_val_1_bismark_bt2_pe.bismark.cov,cases,chr17,76325979,76325979,82.8571428571429,29,6,35
SRR25023301_1_val_1_bismark_bt2_pe.bismark.cov,cases,chr16,23652769,23652769,0.603621730382294,3,494,497
SRR25023301_1_val_1_bismark_bt2_pe.bismark.cov,cases,chr16,23652783,23652783,0.402414486921529,2,495,497
SRR25023301_1_val_1_bismark_bt2_pe.bismark.cov,cases,chr16,23652787,23652787,1.0,5,495,500
SRR25023301_1_val_1_bismark_bt2_pe.bismark.cov,cases,chr16,23652797,23652797,0.403225806451613,2,494,496
SRR25023301_1_val_1_bismark_bt2_pe.bismark.cov,cases,chr16,23652818,23652818,0.612244897959184,3,487,490
SRR25023301_1_val_1_bismark_bt2_pe.bismark.cov,cases,chr16,23652838,23652838,0.204498977505113,1,488,489
SRR25023301_1_val_1_bismark_bt2_pe.bismark.cov,cases,chr16,23652857,23652857,0.0,0,505,505
SRR25023301_1_val_1_bismark_bt2_pe.bismark.cov,cases,chr16,23652860,23652860,0.198412698412698,1,503,504
SRR25023301_1_val_1_bismark_bt2_pe.bismark.cov,cases,chr16,23652876,23652876,0.99009900990099,5,500,505
SRR25023301_1_val_1_bismark_bt2_pe.bismark.cov,cases,chr16,23652906,23652906,0.596421471172962,3,500,503
SRR25023301_1_val_1_bismark_bt2_pe.bismark.cov,cases,chr16,23652911,23652911,1.78926441351889,9,494,503
SRR25023301_1_val_1_bismark_bt2_pe.bismark.cov,cases,chr16,23652916,23652916,1.01214574898785,5,489,494
SRR25023301_1_val_1_bismark_bt2_pe.bismark.cov,cases,chr16,23652918,23652918,1.39442231075697,7,495,502
SRR25023301_1_val_1_bismark_bt2_pe.bismark.cov,cases,chr6,43543548,43543548,0.0,0,112,112
SRR25023301_1_val_1_bismark_bt2_pe.bismark.cov,cases,chr6,43543554,43543554,0.0,0,112,112
SRR25023301_1_val_1_bismark_bt2_pe.bismark.cov,cases,chr6,43543571,43543571,0.0,0,111,111
SRR25023301_1_val_1_bismark_bt2_pe.bismark.cov,cases,chr6,43543578,43543578,0.900900900900901,1,110,111
SRR25023301_1_val_1_bismark_bt2_pe.bismark.cov,cases,chr6,43543580,43543580,0.0,0,111,111
SRR25023301_1_val_1_bismark_bt2_pe.bismark.cov,cases,chr6,43543596,43543596,0.900900900900901,1,110,111
SRR25023301_1_val_1_bismark_bt2_pe.bismark.cov,cases,chr6,43543608,43543608,0.0,0,110,110
SRR25023301_1_val_1_bismark_bt2_pe.bismark.cov,cases,chr6,43543613,43543613,0.0,0,111,111
SRR25023301_1_val_1_bismark_bt2_pe.bismark.cov,cases,chr6,43543615,43543615,0.0,0,111,111
SRR25023301_1_val_1_bismark_bt2_pe.bismark.cov,cases,chr6,43543618,43543618,0.0,0,111,111
SRR25023301_1_val_1_bismark_bt2_pe.bismark.cov,cases,chr6,43543624,43543624,0.900900900900901,1,110,111
SRR25023301_1_val_1_bismark_bt2_pe.bismark.cov,cases,chr6,43543642,43543642,0.900900900900901,1,110,111
SRR25023301_1_val_1_bismark_bt2_pe.bismark.cov,cases,chr6,43543650,43543650,0.0,0,111,111
SRR25023301_1_val_1_bismark_bt2_pe.bismark.cov,cases,chr6,43543657,43543657,0.900900900900901,1,110,111
SRR25023301_1_val_1_bismark_bt2_pe.bismark.cov,cases,chr6,43543669,43543669,0.892857142857143,1,111,112
SRR25023301_1_val_1_bismark_bt2_pe.bismark.cov,cases,chr6,43543672,43543672,0.0,0,111,111
SRR25023301_1_val_1_bismark_bt2_pe.bismark.cov,cases,chr6,43543682,43543682,1.8348623853211,2,107,109
SRR25023301_1_val_1_bismark_bt2_pe.bismark.cov,cases,chr6,43543691,43543691,0.0,0,108,108
SRR25023301_1_val_1_bismark_bt2_pe.bismark.cov,cases,chr6,43543696,43543696,6.42201834862385,7,102,109
SRR25023301_1_val_1_bismark_bt2_pe.bismark.cov,cases,chr6,43543698,43543698,0.0,0,108,108
SRR25023301_1_val_1_bismark_bt2_pe.bismark.cov,cases,chr6,43543701,43543701,1.81818181818182,2,108,110
SRR25023301_1_val_1_bismark_bt2_pe.bismark.cov,cases,chr6,43543705,43543705,0.0,0,111,111
SRR25023301_1_val_1_bismark_bt2_pe.bismark.cov,cases,chr6,43543708,43543708,0.0,0,111,111
SRR25023301_1_val_1_bismark_bt2_pe.bismark.cov,cases,chr6,43543733,43543733,2.77777777777778,3,105,108
SRR25023301_1_val_1_bismark_bt2_pe.bismark.cov,cases,chr6,43543747,43543747,0.925925925925926,1,107,108
SRR25023301_1_val_1_bismark_bt2_pe.bismark.cov,cases,chr6,43543749,43543749,0.0,0,108,108
SRR25023301_1_val_1_bismark_bt2_pe.bismark.cov,cases,chr6,43543763,43543763,0.0,0,107,107
SRR25023301_1_val_1_bismark_bt2_pe.bismark.cov,cases,chr6,43543766,43543766,0.934579439252336,1,106,107
SRR25023301_1_val_1_bismark_bt2_pe.bismark.cov,cases,chr6,43543771,43543771,0.0,0,110,110
SRR25023301_1_val_1_bismark_bt2_pe.bismark.cov,cases,chr6,43543775,43543775,0.0,0,106,106
SRR25023301_1_val_1_bismark_bt2_pe.bismark.cov,cases,chr6,43543777,43543777,2.85714285714286,3,102,105
SRR25023301_1_val_1_bismark_bt2_pe.bismark.cov,cases,chr6,43543781,43543781,0.0,0,107,107
SRR25023301_1_val_1_bismark_bt2_pe.bismark.cov,cases,chr6,43543786,43543786,0.934579439252336,1,106,107
SRR25023301_1_val_1_bismark_bt2_pe.bismark.cov,cases,chr6,43543794,43543794,0.0,0,109,109
SRR25023301_1_val_1_bismark_bt2_pe.bismark.cov,cases,chr6,43543798,43543798,0.0,0,109,109
SRR25023301_1_val_1_bismark_bt2_pe.bismark.cov,cases,chr6,43543800,43543800,0.0,0,109,109
SRR25023301_1_val_1_bismark_bt2_pe.bismark.cov,cases,chr6,43543804,43543804,0.925925925925926,1,107,108
SRR25023301_1_val_1_bismark_bt2_pe.bismark.cov,cases,chr6,43543806,43543806,1.85185185185185,2,106,108
SRR25023301_1_val_1_bismark_bt2_pe.bismark.cov,cases,chr6,43543815,43543815,1.81818181818182,2,108,110
SRR25023301_1_val_1_bismark_bt2_pe.bismark.cov,cases,chr6,43543822,43543822,0.0,0,111,111
SRR25023301_1_val_1_bismark_bt2_pe.bismark.cov,cases,chr7,6048869,6048869,0.504484304932735,18,3550,3568
SRR25023301_1_val_1_bismark_bt2_pe.bismark.cov,cases,chr7,6048876,6048876,0.702049985959,25,3536,3561
SRR25023301_1_val_1_bismark_bt2_pe.bismark.cov,cases,chr7,6048884,6048884,0.897615708274895,32,3533,3565
SRR25023301_1_val_1_bismark_bt2_pe.bismark.cov,cases,chr7,6048888,6048888,0.562271577171774,20,3537,3557
SRR25023301_1_val_1_bismark_bt2_pe.bismark.cov,cases,chr7,6048892,6048892,0.815523059617548,29,3527,3556
SRR25023301_1_val_1_bismark_bt2_pe.bismark.cov,cases,chr7,6048904,6048904,0.0,0,724,724
SRR25023301_1_val_1_bismark_bt2_pe.bismark.cov,cases,chr7,6048918,6048918,0.252808988764045,9,3551,3560
SRR25023301_1_val_1_bismark_bt2_pe.bismark.cov,cases,chr7,6048925,6048925,0.336700336700337,12,3552,3564
SRR25023301_1_val_1_bismark_bt2_pe.bismark.cov,cases,chr7,6048928,6048928,0.588895120583287,21,3545,3566
SRR25023301_1_val_1_bismark_bt2_pe.bismark.cov,cases,chr7,6048940,6048940,0.952647800504343,34,3535,3569
SRR25023301_1_val_1_bismark_bt2_pe.bismark.cov,cases,chr7,6048951,6048951,0.5890603085554,21,3544,3565
SRR25023301_1_val_1_bismark_bt2_pe.bismark.cov,cases,chr7,6048966,6048966,0.448681996634885,16,3550,3566
SRR25023301_1_val_1_bismark_bt2_pe.bismark.cov,cases,chr7,6048968,6048968,0.58972198820556,21,3540,3561
SRR25023301_1_val_1_bismark_bt2_pe.bismark.cov,cases,chr22,29137950,29137950,1.49253731343284,1,66,67
SRR25023301_1_val_1_bismark_bt2_pe.bismark.cov,cases,chr22,29137964,29137964,0.0,0,60,60
SRR25023301_1_val_1_bismark_bt2_pe.bismark.cov,cases,chr22,29137975,29137975,0.0,0,54,54
SRR25023301_1_val_1_bismark_bt2_pe.bismark.cov,cases,chr22,29137985,29137985,0.0,0,41,41
SRR25023301_1_val_1_bismark_bt2_pe.bismark.cov,cases,chr22,29137993,29137993,0.0,0,32,32
SRR25023301_1_val_1_bismark_bt2_pe.bismark.cov,cases,chr22,29138031,29138031,0.0,0,60,60
SRR25023301_1_val_1_bismark_bt2_pe.bismark.cov,cases,chr22,29138052,29138052,0.0,0,61,61
SRR25023301_1_val_1_bismark_bt2_pe.bismark.cov,cases,chr22,29138062,29138062,0.0,0,63,63
SRR25023301_1_val_1_bismark_bt2_pe.bismark.cov,cases,chr22,29138075,29138075,0.0,0,64,64
SRR25023301_1_val_1_bismark_bt2_pe.bismark.cov,cases,chr22,29138078,29138078,0.0,0,64,64
SRR25023301_1_val_1_bismark_bt2_pe.bismark.cov,cases,chr22,29138091,29138091,0.0,0,59,59
SRR25023301_1_val_1_bismark_bt2_pe.bismark.cov,cases,chr22,29138102,29138102,0.0,0,63,63
SRR25023301_1_val_1_bismark_bt2_pe.bismark.cov,cases,chr22,29138115,29138115,0.0,0,62,62
SRR25023301_1_val_1_bismark_bt2_pe.bismark.cov,cases,chr22,29138134,29138134,0.0,0,64,64
SRR25023301_1_val_1_bismark_bt2_pe.bismark.cov,cases,chr22,29138158,29138158,0.0,0,66,66
SRR25023301_1_val_1_bismark_bt2_pe.bismark.cov,cases,chr22,29138168,29138168,0.0,0,66,66
SRR25023301_1_val_1_bismark_bt2_pe.bismark.cov,cases,chr22,29138176,29138176,0.0,0,67,67
SRR25023301_1_val_1_bismark_bt2_pe.bismark.cov,cases,chr22,29138179,29138179,0.0,0,67,67
SRR25023301_1_val_1_bismark_bt2_pe.bismark.cov,cases,chr22,29138185,29138185,1.49253731343284,1,66,67
SRR25023301_1_val_1_bismark_bt2_pe.bismark.cov,cases,chr22,29138202,29138202,0.0,0,67,67
SRR25023301_1_val_1_bismark_bt2_pe.bismark.cov,cases,chr22,29138216,29138216,0.0,0,68,68
SRR25023301_1_val_1_bismark_bt2_pe.bismark.cov,cases,chr22,29138219,29138219,0.0,0,68,68
SRR25023301_1_val_1_bismark_bt2_pe.bismark.cov,cases,chr22,29138234,29138234,0.0,0,68,68
SRR25023301_1_val_1_bismark_bt2_pe.bismark.cov,cases,chr22,29138238,29138238,0.0,0,68,68
SRR25023301_1_val_1_bismark_bt2_pe.bismark.cov,cases,chrX,14891454,14891454,34.8928463628132,1156,2157,3313
SRR25023301_1_val_1_bismark_bt2_pe.bismark.cov,cases,chrX,14891470,14891470,24.6218995765275,814,2492,3306
SRR25023301_1_val_1_bismark_bt2_pe.bismark.cov,cases,chrX,14891474,14891474,34.3712212817412,1137,2171,3308
SRR25023301_1_val_1_bismark_bt2_pe.bismark.cov,cases,chrX,14891488,14891488,29.0887145443573,964,2350,3314
SRR25023301_1_val_1_bismark_bt2_pe.bismark.cov,cases,chrX,14891493,14891493,45.8220211161388,1519,1796,3315
SRR25023301_1_val_1_bismark_bt2_pe.bismark.cov,cases,chrX,14891496,14891496,39.4387447193724,1307,2007,3314
SRR25023301_1_val_1_bismark_bt2_pe.bismark.cov,cases,chrX,14891499,14891499,30.4977375565611,1011,2304,3315
SRR25023301_1_val_1_bismark_bt2_pe.bismark.cov,cases,chrX,14891509,14891509,43.1248111211846,1427,1882,3309
SRR25023301_1_val_1_bismark_bt2_pe.bismark.cov,cases,chrX,14891516,14891516,45.7376058041112,1513,1795,3308
SRR25023301_1_val_1_bismark_bt2_pe.bismark.cov,cases,chrX,14891524,14891524,33.5550181378476,1110,2198,3308
SRR25023301_1_val_1_bismark_bt2_pe.bismark.cov,cases,chrX,14891526,14891526,36.0749924402782,1193,2114,3307
SRR25023301_1_val_1_bismark_bt2_pe.bismark.cov,cases,chrX,14891530,14891530,40.3747355696585,1336,1973,3309
SRR25023302_1_val_1_bismark_bt2_pe.bismark.cov,cases,chr3,37034307,37034307,99.9356499356499,3106,2,3108
SRR25023302_1_val_1_bismark_bt2_pe.bismark.cov,cases,chr3,37034316,37034316,0.0642880102860816,2,3109,3111
SRR25023302_1_val_1_bismark_bt2_pe.bismark.cov,cases,chr3,37034324,37034324,0.160720025715204,5,3106,3111
SRR25023302_1_val_1_bismark_bt2_pe.bismark.cov,cases,chr3,37034330,37034330,0.224791265253693,7,3107,3114
SRR25023302_1_val_1_bismark_bt2_pe.bismark.cov,cases,chr3,37034344,37034344,0.48185030517186,15,3098,3113
SRR25023302_1_val_1_bismark_bt2_pe.bismark.cov,cases,chr3,37034346,37034346,0.514634930845931,16,3093,3109
SRR25023302_1_val_1_bismark_bt2_pe.bismark.cov,cases,chr3,37034348,37034348,0.997425997425997,31,3077,3108
SRR25023302_1_val_1_bismark_bt2_pe.bismark.cov,cases,chr3,37034352,37034352,0.51413881748072,16,3096,3112
SRR25023302_1_val_1_bismark_bt2_pe.bismark.cov,cases,chr3,37034355,37034355,0.28892455858748,9,3106,3115
SRR25023302_1_val_1_bismark_bt2_pe.bismark.cov,cases,chr3,37034359,37034359,0.610343719884356,19,3094,3113
SRR25023302_1_val_1_bismark_bt2_pe.bismark.cov,cases,chr3,37034369,37034369,0.91533180778032,28,3031,3059
SRR25023302_1_val_1_bismark_bt2_pe.bismark.cov,cases,chr3,37034373,37034373,0.513643659711075,16,3099,3115
SRR25023302_1_val_1_bismark_bt2_pe.bismark.cov,cases,chr3,37034382,37034382,0.352451137455944,11,3110,3121
SRR25023302_1_val_1_bismark_bt2_pe.bismark.cov,cases,chr3,37034394,37034394,0.544348382965098,17,3106,3123
SRR25023302_1_val_1_bismark_bt2_pe.bismark.cov,cases,chr3,37034402,37034402,0.545221295702373,17,3101,3118
SRR25023302_1_val_1_bismark_bt2_pe.bismark.cov,cases,chr3,37034409,37034409,0.352225424271534,11,3112,3123
SRR25023302_1_val_1_bismark_bt2_pe.bismark.cov,cases,chr3,37034412,37034412,0.51249199231262,16,3106,3122
SRR25023302_1_val_1_bismark_bt2_pe.bismark.cov,cases,chr3,37034414,37034414,0.673940949935815,21,3095,3116
SRR25023302_1_val_1_bismark_bt2_pe.bismark.cov,cases,chr3,37034418,37034418,0.706260032102729,22,3093,3115
SRR25023302_1_val_1_bismark_bt2_pe.bismark.cov,cases,chr3,37034420,37034420,0.288831835686778,9,3107,3116
SRR25023302_1_val_1_bismark_bt2_pe.bismark.cov,cases,chr3,37034430,37034430,0.288646568313021,9,3109,3118
SRR25023302_1_val_1_bismark_bt2_pe.bismark.cov,cases,chr3,37034438,37034438,0.192184497117233,6,3116,3122
SRR25023302_1_val_1_bismark_bt2_pe.bismark.cov,cases,chr3,37034441,37034441,0.288554023725553,9,3110,3119
SRR25023302_1_val_1_bismark_bt2_pe.bismark.cov,cases,chr3,37034466,37034466,100.0,3113,0,3113
SRR25023302_1_val_1_bismark_bt2_pe.bismark.cov,cases,chr3,37034997,37034997,0.797101449275362,33,4107,4140
SRR25023302_1_val_1_bismark_bt2_pe.bismark.cov,cases,chr3,37035012,37035012,0.0724462690171456,3,4138,4141
SRR25023302_1_val_1_bismark_bt2_pe.bismark.cov,cases,chr3,37035032,37035032,0.507246376811594,21,4119,4140
SRR25023302_1_val_1_bismark_bt2_pe.bismark.cov,cases,chr3,37035043,37035043,0.289645184648805,12,4131,4143
SRR25023302_1_val_1_bismark_bt2_pe.bismark.cov,cases,chr3,37035047,37035047,0.41023166023166,17,4127,4144
SRR25023302_1_val_1_bismark_bt2_pe.bismark.cov,cases,chr3,37035063,37035063,0.675186882083434,28,4119,4147
SRR25023302_1_val_1_bismark_bt2_pe.bismark.cov,cases,chr3,37035066,37035066,0.337512054001929,14,4134,4148
SRR25023302_1_val_1_bismark_bt2_pe.bismark.cov,cases,chr3,37035074,37035074,0.314389359129383,13,4122,4135
SRR25023302_1_val_1_bismark_bt2_pe.bismark.cov,cases,chr3,37035090,37035090,1.01400289715113,42,4100,4142
SRR25023302_1_val_1_bismark_bt2_pe.bismark.cov,cases,chr3,37035095,37035095,1.18243243243243,49,4095,4144
SRR25023302_1_val_1_bismark_bt2_pe.bismark.cov,cases,chr3,37035097,37035097,0.506634499396864,21,4124,4145
SRR25023302_1_val_1_bismark_bt2_pe.bismark.cov,cases,chr3,37035100,37035100,0.169082125603865,7,4133,4140
SRR25023302_1_val_1_bismark_bt2_pe.bismark.cov,cases,chr3,37035117,37035117,0.700652331481034,29,4110,4139
SRR25023302_1_val_1_bismark_bt2_pe.bismark.cov,cases,chr3,142297977,142297977,0.578778135048232,9,1546,1555
SRR25023302_1_val_1_bismark_bt2_pe.bismark.cov,cases,chr3,142298019,142298019,0.900900900900901,14,1540,1554
SRR25023302_1_val_1_bismark_bt2_pe.bismark.cov,cases,chr3,142298045,142298045,0.900900900900901,14,1540,1554
SRR25023302_1_val_1_bismark_bt2_pe.bismark.cov,cases,chr3,142298054,142298054,3.99742101869761,62,1489,1551
SRR25023302_1_val_1_bismark_bt2_pe.bismark.cov,cases,chr13,32889392,32889392,20.3631647211414,785,3070,3855
SRR25023302_1_val_1_bismark_bt2_pe.bismark.cov,cases,chr13,32889434,32889434,2.23434658352819,86,3763,3849
SRR25023302_1_val_1_bismark_bt2_pe.bismark.cov,cases,chr13,32889461,32889461,0.677083333333333,26,3814,3840
SRR25023302_1_val_1_bismark_bt2_pe.bismark.cov,cases,chr13,32889470,32889470,0.389914218871848,15,3832,3847
SRR25023302_1_val_1_bismark_bt2_pe.bismark.cov,cases,chr13,32889484,32889484,0.363919937613725,14,3833,3847
SRR25023302_1_val_1_bismark_bt2_pe.bismark.cov,cases,chr13,108867034,108867034,41.3863404689093,406,575,981
SRR25023302_1_val_1_bismark_bt2_pe.bismark.cov,cases,chr13,108867044,108867044,47.3,473,527,1000
SRR25023302_1_val_1_bismark_bt2_pe.bismark.cov,cases,chr13,108867051,108867051,39.5791583166333,395,603,998
SRR25023302_1_val_1_bismark_bt2_pe.bismark.cov,cases,chr13,108867109,108867109,51.4910536779324,518,488,1006
SRR25023302_1_val_1_bismark_bt2_pe.bismark.cov,cases,chr13,108867112,108867112,58.051689860835,584,422,1006
SRR25023302_1_val_1_bismark_bt2_pe.bismark.cov,cases,chr13,108867124,108867124,46.8127490039841,470,534,1004
SRR25023302_1_val_1_bismark_bt2_pe.bismark.cov,cases,chr13,108867135,108867135,34.2629482071713,344,660,1004
SRR25023302_1_val_1_bismark_bt2_pe.bismark.cov,cases,chr13,108867155,108867155,33.8677354709419,338,660,998
SRR25023302_1_val_1_bismark_bt2_pe.bismark.cov,cases,chr2,47596828,47596828,3.81054131054131,107,2701,2808
SRR25023302_1_val_1_bismark_bt2_pe.bismark.cov,cases,chr2,47596830,47596830,4.28370786516854,122,2726,2848
SRR25023302_1_val_1_bismark_bt2_pe.bismark.cov,cases,chr2,47596840,47596840,5.32026601330067,152,2705,2857
SRR25023302_1_val_1_bismark_bt2_pe.bismark.cov,cases,chr2,47596849,47596849,20.7896575821104,595,2267,2862
SRR25023302_1_val_1_bismark_bt2_pe.bismark.cov,cases,chr2,47596853,47596853,6.85314685314685,196,2664,2860
SRR25023302_1_val_1_bismark_bt2_pe.bismark.cov,cases,chr2,47596858,47596858,11.3676110528157,325,2534,2859
SRR25023302_1_val_1_bismark_bt2_pe.bismark.cov,cases,chr2,47596862,47596862,9.50716532680881,272,2589,2861
SRR25023302_1_val_1_bismark_bt2_pe.bismark.cov,cases,chr2,47596869,47596869,20.0069832402235,573,2291,2864
SRR25023302_1_val_1_bismark_bt2_pe.bismark.cov,cases,chr2,47596883,47596883,14.9859943977591,428,2428,2856
SRR25023302_1_val_1_bismark_bt2_pe.bismark.cov,cases,chr2,47596885,47596885,4.83193277310924,138,2718,2856
SRR25023302_1_val_1_bismark_bt2_pe.bismark.cov,cases,chr2,47596887,47596887,8.47042352117606,242,2615,2857
SRR25023302_1_val_1_bismark_bt2_pe.bismark.cov,cases,chr2,47596897,47596897,6.79033951697585,194,2663,2857
SRR25023302_1_val_1_bismark_bt2_pe.bismark.cov,cases,chr2,47596900,47596900,4.6584938704028,133,2722,2855
SRR25023302_1_val_1_bismark_bt2_pe.bismark.cov,cases,chr2,47596907,47596907,3.50385423966363,100,2754,2854
SRR25023302_1_val_1_bismark_bt2_pe.bismark.cov,cases,chr2,47596912,47596912,2.24246671338472,64,2790,2854
SRR25023302_1_val_1_bismark_bt2_pe.bismark.cov,cases,chr2,47596930,47596930,6.53617616218106,187,2674,2861
SRR25023302_1_val_1_bismark_bt2_pe.bismark.cov,cases,chr2,47596942,47596942,6.78321678321678,194,2666,2860
SRR25023302_1_val_1_bismark_bt2_pe.bismark.cov,cases,chr2,47630224,47630224,0.937709310113865,14,1479,1493
SRR25023302_1_val_1_bismark_bt2_pe.bismark.cov,cases,chr2,47630227,47630227,0.851342501637197,13,1514,1527
SRR25023302_1_val_1_bismark_bt2_pe.bismark.cov,cases,chr2,47630233,47630233,0.0,0,1528,1528
SRR25023302_1_val_1_bismark_bt2_pe.bismark.cov,cases,chr2,47630237,47630237,0.327225130890052,5,1523,1528
SRR25023302_1_val_1_bismark_bt2_pe.bismark.cov,cases,chr2,47630240,47630240,0.589005235602094,9,1519,1528
SRR25023302_1_val_1_bismark_bt2_pe.bismark.cov,cases,chr2,47630244,47630244,0.654878847413229,10,1517,1527
SRR25023302_1_val_1_bismark_bt2_pe.bismark.cov,cases,chr2,47630251,47630251,0.523560209424084,8,1520,1528
SRR25023302_1_val_1_bismark_bt2_pe.bismark.cov,cases,chr2,47630265,47630265,0.458715596330275,7,1519,1526
SRR25023302_1_val_1_bismark_bt2_pe.bismark.cov,cases,chr2,47630292,47630292,0.327653997378768,5,1521,1526
SRR25023302_1_val_1_bismark_bt2_pe.bismark.cov,cases,chr2,47630294,47630294,0.525279054497702,8,1515,1523
SRR25023302_1_val_1_bismark_bt2_pe.bismark.cov,cases,chr2,128051674,128051674,0.0,0,208,208
SRR25023302_1_val_1_bismark_bt2_pe.bismark.cov,cases,chr2,128051690,128051690,1.20160213618158,9,740,749
SRR25023302_1_val_1_bismark_bt2_pe.bismark.cov,cases,chr2,128051704,128051704,0.133511348464619,1,748,749
SRR25023302_1_val_1_bismark_bt2_pe.bismark.cov,cases,chr2,128051707,128051707,0.801068090787717,6,743,749
SRR25023302_1_val_1_bismark_bt2_pe.bismark.cov,cases,chr2,128051709,128051709,0.934579439252336,7,742,749
SRR25023302_1_val_1_bismark_bt2_pe.bismark.cov,cases,chr2,128051716,128051716,0.267379679144385,2,746,748
SRR25023302_1_val_1_bismark_bt2_pe.bismark.cov,cases,chr2,128051733,128051733,0.666666666666667,5,745,750
SRR25023302_1_val_1_bismark_bt2_pe.bismark.cov,cases,chr2,128051743,128051743,0.802139037433155,6,742,748
SRR25023302_1_val_1_bismark_bt2_pe.bismark.cov,cases,chr2,178787742,178787742,91.5909090909091,403,37,440
SRR25023302_1_val_1_bismark_bt2_pe.bismark.cov,cases,chr10,89619506,89619506,97.9759645793801,1549,32,1581
SRR25023302_1_val_1_bismark_bt2_pe.bismark.cov,cases,chr10,89619510,89619510,98.2300884955752,1554,28,1582
SRR25023302_1_val_1_bismark_bt2_pe.bismark.cov,cases,chr10,89619512,89619512,98.3596214511041,1559,26,1585
SRR25023302_1_val_1_bismark_bt2_pe.bismark.cov,cases,chr10,89619522,89619522,97.3568281938326,1547,42,1589
SRR25023302_1_val_1_bismark_bt2_pe.bismark.cov,cases,chr10,89619550,89619550,96.6624685138539,1535,53,1588
SRR25023302_1_val_1_bismark_bt2_pe.bismark.cov,cases,chr10,89619555,89619555,97.7945809703844,1552,35,1587
SRR25023302_1_val_1_bismark_bt2_pe.bismark.cov,cases,chr10,89619566,89619566,92.739898989899,1469,115,1584
SRR25023302_1_val_1_bismark_bt2_pe.bismark.cov,cases,chr10,89619580,89619580,91.6666666666667,1452,132,1584
SRR25023302_1_val_1_bismark_bt2_pe.bismark.cov,cases,chr11,108093323,108093323,0.353356890459364,2,564,566
SRR25023302_1_val_1_bismark_bt2_pe.bismark.cov,cases,chr11,108093335,108093335,0.530973451327434,3,562,565
SRR25023302_1_val_1_bismark_bt2_pe.bismark.cov,cases,chr11,108093338,108093338,0.355239786856128,2,561,563
SRR25023302_1_val_1_bismark_bt2_pe.bismark.cov,cases,chr11,108093359,108093359,0.17921146953405,1,557,558
SRR25023302_1_val_1_bismark_bt2_pe.bismark.cov,cases,chr11,108093371,108093371,1.19904076738609,5,412,417
SRR25023302_1_val_1_bismark_bt2_pe.bismark.cov,cases,chr11,108093373,108093373,0.719424460431655,3,414,417
SRR25023302_1_val_1_bismark_bt2_pe.bismark.cov,cases,chr11,108093386,108093386,0.240384615384615,1,415,416
SRR25023302_1_val_1_bismark_bt2_pe.bismark.cov,cases,chr11,108093395,108093395,0.970873786407767,4,408,412
SRR25023302_1_val_1_bismark_bt2_pe.bismark.cov,cases,chr11,108093402,108093402,0.72992700729927,3,408,411
SRR25023302_1_val_1_bismark_bt2_pe.bismark.cov,cases,chr11,108093413,108093413,0.0,0,407,407
SRR25023302_1_val_1_bismark_bt2_pe.bismark.cov,cases,chr11,108093419,108093419,0.246305418719212,1,405,406
SRR25023302_1_val_1_bismark_bt2_pe.bismark.cov,cases,chr11,108093436,108093436,0.492610837438424,2,404,406
SRR25023302_1_val_1_bismark_bt2_pe.bismark.cov,cases,chr11,108093439,108093439,0.246913580246914,1,404,405
SRR25023302_1_val_1_bismark_bt2_pe.bismark.cov,cases,chr11,108093451,108093451,0.248138957816377,1,402,403
SRR25023302_1_val_1_bismark_bt2_pe.bismark.cov,cases,chr11,108093457,108093457,0.248756218905473,1,401,402
SRR25023302_1_val_1_bismark_bt2_pe.bismark.cov,cases,chr11,108093461,108093461,0.748129675810474,3,398,401
SRR25023302_1_val_1_bismark_bt2_pe.bismark.cov,cases,chr11,108093467,108093467,0.0,0,401,401
SRR25023302_1_val_1_bismark_bt2_pe.bismark.cov,cases,chr11,108093476,108093476,0.249376558603491,1,400,401
SRR25023302_1_val_1_bismark_bt2_pe.bismark.cov,cases,chr11,108093485,108093485,0.761421319796954,3,391,394
SRR25023302_1_val_1_bismark_bt2_pe.bismark.cov,cases,chr11,108093505,108093505,1.11731843575419,4,354,358
SRR25023302_1_val_1_bismark_bt2_pe.bismark.cov,cases,chr11,108093520,108093520,0.333333333333333,1,299,300
SRR25023302_1_val_1_bismark_bt2_pe.bismark.cov,cases,chr11,108093560,108093560,0.0,0,322,322
SRR25023302_1_val_1_bismark_bt2_pe.bismark.cov,cases,chr11,108093567,108093567,0.87463556851312,3,340,343
SRR25023302_1_val_1_bismark_bt2_pe.bismark.cov,cases,chr11,108093572,108093572,0.869565217391304,3,342,345
SRR25023302_1_val_1_bismark_bt2_pe.bismark.cov,cases,chr11,108093579,108093579,0.563380281690141,2,353,355
SRR25023302_1_val_1_bismark_bt2_pe.bismark.cov,cases,chr11,108093584,108093584,1.07816711590297,4,367,371
SRR25023302_1_val_1_bismark_bt2_pe.bismark.cov,cases,chr11,108093590,108093590,0.51150895140665,2,389,391
SRR25023302_1_val_1_bismark_bt2_pe.bismark.cov,cases,chr11,108093598,108093598,0.995024875621891,4,398,402
SRR25023302_1_val_1_bismark_bt2_pe.bismark.cov,cases,chr6,43543548,43543548,1.62162162162162,3,182,185
SRR25023302_1_val_1_bismark_bt2_pe.bismark.cov,cases,chr6,43543554,43543554,0.0,0,185,185
SRR25023302_1_val_1_bismark_bt2_pe.bismark.cov,cases,chr6,43543571,43543571,0.537634408602151,1,185,186
SRR25023302_1_val_1_bismark_bt2_pe.bismark.cov,cases,chr6,43543578,43543578,0.0,0,186,186
SRR25023302_1_val_1_bismark_bt2_pe.bismark.cov,cases,chr6,43543580,43543580,0.0,0,186,186
SRR25023302_1_val_1_bismark_bt2_pe.bismark.cov,cases,chr6,43543596,43543596,0.0,0,188,188
SRR25023302_1_val_1_bismark_bt2_pe.bismark.cov,cases,chr6,43543608,43543608,0.0,0,186,186
SRR25023302_1_val_1_bismark_bt2_pe.bismark.cov,cases,chr6,43543613,43543613,1.06951871657754,2,185,187
SRR25023302_1_val_1_bismark_bt2_pe.bismark.cov,cases,chr6,43543615,43543615,2.13903743315508,4,183,187
SRR25023302_1_val_1_bismark_bt2_pe.bismark.cov,cases,chr6,43543618,43543618,1.60427807486631,3,184,187
SRR25023302_1_val_1_bismark_bt2_pe.bismark.cov,cases,chr6,43543624,43543624,1.0752688172043,2,184,186
SRR25023302_1_val_1_bismark_bt2_pe.bismark.cov,cases,chr6,43543642,43543642,0.0,0,186,186
SRR25023302_1_val_1_bismark_bt2_pe.bismark.cov,cases,chr6,43543650,43543650,0.0,0,187,187
SRR25023302_1_val_1_bismark_bt2_pe.bismark.cov,cases,chr6,43543657,43543657,0.540540540540541,1,184,185
SRR25023302_1_val_1_bismark_bt2_pe.bismark.cov,cases,chr6,43543669,43543669,0.540540540540541,1,184,185
SRR25023302_1_val_1_bismark_bt2_pe.bismark.cov,cases,chr6,43543672,43543672,0.546448087431694,1,182,183
SRR25023302_1_val_1_bismark_bt2_pe.bismark.cov,cases,chr6,43543682,43543682,0.0,0,182,182
SRR25023302_1_val_1_bismark_bt2_pe.bismark.cov,cases,chr6,43543691,43543691,0.552486187845304,1,180,181
SRR25023302_1_val_1_bismark_bt2_pe.bismark.cov,cases,chr6,43543696,43543696,6.17977528089888,11,167,178
SRR25023302_1_val_1_bismark_bt2_pe.bismark.cov,cases,chr6,43543698,43543698,0.561797752808989,1,177,178
SRR25023302_1_val_1_bismark_bt2_pe.bismark.cov,cases,chr6,43543701,43543701,2.24719101123596,4,174,178
SRR25023302_1_val_1_bismark_bt2_pe.bismark.cov,cases,chr6,43543705,43543705,0.0,0,178,178
SRR25023302_1_val_1_bismark_bt2_pe.bismark.cov,cases,chr6,43543708,43543708,0.0,0,178,178
SRR25023302_1_val_1_bismark_bt2_pe.bismark.cov,cases,chr6,43543733,43543733,0.552486187845304,1,180,181
SRR25023302_1_val_1_bismark_bt2_pe.bismark.cov,cases,chr6,43543747,43543747,1.0989010989011,2,180,182
SRR25023302_1_val_1_bismark_bt2_pe.bismark.cov,cases,chr6,43543749,43543749,0.0,0,182,182
SRR25023302_1_val_1_bismark_bt2_pe.bismark.cov,cases,chr6,43543763,43543763,0.555555555555556,1,179,180
SRR25023302_1_val_1_bismark_bt2_pe.bismark.cov,cases,chr6,43543766,43543766,0.552486187845304,1,180,181
SRR25023302_1_val_1_bismark_bt2_pe.bismark.cov,cases,chr6,43543771,43543771,1.0989010989011,2,180,182
SRR25023302_1_val_1_bismark_bt2_pe.bismark.cov,cases,chr6,43543775,43543775,0.0,0,179,179
SRR25023302_1_val_1_bismark_bt2_pe.bismark.cov,cases,chr6,43543777,43543777,0.555555555555556,1,179,180
SRR25023302_1_val_1_bismark_bt2_pe.bismark.cov,cases,chr6,43543781,43543781,0.0,0,182,182
SRR25023302_1_val_1_bismark_bt2_pe.bismark.cov,cases,chr6,43543786,43543786,0.549450549450549,1,181,182
SRR25023302_1_val_1_bismark_bt2_pe.bismark.cov,cases,chr6,43543794,43543794,1.11111111111111,2,178,180
SRR25023302_1_val_1_bismark_bt2_pe.bismark.cov,cases,chr6,43543798,43543798,1.11111111111111,2,178,180
SRR25023302_1_val_1_bismark_bt2_pe.bismark.cov,cases,chr6,43543800,43543800,0.558659217877095,1,178,179
SRR25023302_1_val_1_bismark_bt2_pe.bismark.cov,cases,chr6,43543804,43543804,0.555555555555556,1,179,180
SRR25023302_1_val_1_bismark_bt2_pe.bismark.cov,cases,chr6,43543806,43543806,1.66666666666667,3,177,180
SRR25023302_1_val_1_bismark_bt2_pe.bismark.cov,cases,chr6,43543815,43543815,0.0,0,181,181
SRR25023302_1_val_1_bismark_bt2_pe.bismark.cov,cases,chr6,43543822,43543822,0.555555555555556,1,179,180
SRR25023302_1_val_1_bismark_bt2_pe.bismark.cov,cases,chr17,41277106,41277106,1.0507880910683,18,1695,1713
SRR25023302_1_val_1_bismark_bt2_pe.bismark.cov,cases,chr17,41277115,41277115,0.75713453698311,13,1704,1717
SRR25023302_1_val_1_bismark_bt2_pe.bismark.cov,cases,chr17,41277117,41277117,0.69889341875364,12,1705,1717
SRR25023302_1_val_1_bismark_bt2_pe.bismark.cov,cases,chr17,41277153,41277153,0.817757009345794,14,1698,1712
SRR25023302_1_val_1_bismark_bt2_pe.bismark.cov,cases,chr17,41277160,41277160,0.991831971995333,17,1697,1714
SRR25023302_1_val_1_bismark_bt2_pe.bismark.cov,cases,chr17,41277174,41277174,1.28279883381924,22,1693,1715
SRR25023302_1_val_1_bismark_bt2_pe.bismark.cov,cases,chr17,41277187,41277187,5.51267916207277,50,857,907
SRR25023302_1_val_1_bismark_bt2_pe.bismark.cov,cases,chr17,41277214,41277214,0.812064965197216,14,1710,1724
SRR25023302_1_val_1_bismark_bt2_pe.bismark.cov,cases,chr17,41277232,41277232,0.809248554913295,14,1716,1730
SRR25023302_1_val_1_bismark_bt2_pe.bismark.cov,cases,chr17,56769746,56769746,89.9328859060403,134,15,149
SRR25023302_1_val_1_bismark_bt2_pe.bismark.cov,cases,chr17,56769760,56769760,85.9060402684564,128,21,149
SRR25023302_1_val_1_bismark_bt2_pe.bismark.cov,cases,chr17,56769767,56769767,75.5102040816327,111,36,147
SRR25023302_1_val_1_bismark_bt2_pe.bismark.cov,cases,chr17,56769830,56769830,1.97368421052632,3,149,152
SRR25023302_1_val_1_bismark_bt2_pe.bismark.cov,cases,chr17,56769866,56769866,1.32450331125828,2,149,151
SRR25023302_1_val_1_bismark_bt2_pe.bismark.cov,cases,chr17,56769883,56769883,0.0,0,151,151
SRR25023302_1_val_1_bismark_bt2_pe.bismark.cov,cases,chr17,56769891,56769891,0.0,0,151,151
SRR25023302_1_val_1_bismark_bt2_pe.bismark.cov,cases,chr17,56769895,56769895,0.662251655629139,1,150,151
SRR25023302_1_val_1_bismark_bt2_pe.bismark.cov,cases,chr17,56769904,56769904,0.671140939597315,1,148,149
SRR25023302_1_val_1_bismark_bt2_pe.bismark.cov,cases,chr17,56769912,56769912,2.01342281879195,3,146,149
SRR25023302_1_val_1_bismark_bt2_pe.bismark.cov,cases,chr17,56769922,56769922,0.0,0,148,148
SRR25023302_1_val_1_bismark_bt2_pe.bismark.cov,cases,chr17,56769929,56769929,0.0,0,146,146
SRR25023302_1_val_1_bismark_bt2_pe.bismark.cov,cases,chr17,56769936,56769936,0.0,0,146,146
SRR25023302_1_val_1_bismark_bt2_pe.bismark.cov,cases,chr17,56769941,56769941,0.0,0,146,146
SRR25023302_1_val_1_bismark_bt2_pe.bismark.cov,cases,chr17,56769944,56769944,0.0,0,147,147
SRR25023302_1_val_1_bismark_bt2_pe.bismark.cov,cases,chr17,56769948,56769948,0.680272108843537,1,146,147
SRR25023302_1_val_1_bismark_bt2_pe.bismark.cov,cases,chr17,56769956,56769956,0.0,0,138,138
SRR25023302_1_val_1_bismark_bt2_pe.bismark.cov,cases,chr17,56769962,56769962,0.0,0,130,130
SRR25023302_1_val_1_bismark_bt2_pe.bismark.cov,cases,chr17,56769966,56769966,0.0,0,128,128
SRR25023302_1_val_1_bismark_bt2_pe.bismark.cov,cases,chr17,56769982,56769982,0.0,0,135,135
SRR25023302_1_val_1_bismark_bt2_pe.bismark.cov,cases,chr17,56770003,56770003,0.0,0,139,139
SRR25023302_1_val_1_bismark_bt2_pe.bismark.cov,cases,chr17,56770008,56770008,0.0,0,139,139
SRR25023302_1_val_1_bismark_bt2_pe.bismark.cov,cases,chr17,56770010,56770010,0.0,0,139,139
SRR25023302_1_val_1_bismark_bt2_pe.bismark.cov,cases,chr17,56770018,56770018,0.0,0,144,144
SRR25023302_1_val_1_bismark_bt2_pe.bismark.cov,cases,chr17,56770023,56770023,0.0,0,144,144
SRR25023302_1_val_1_bismark_bt2_pe.bismark.cov,cases,chr17,56770038,56770038,0.0,0,146,146
SRR25023302_1_val_1_bismark_bt2_pe.bismark.cov,cases,chr17,56770057,56770057,0.0,0,147,147
SRR25023302_1_val_1_bismark_bt2_pe.bismark.cov,cases,chr17,56770069,56770069,0.0,0,147,147
SRR25023302_1_val_1_bismark_bt2_pe.bismark.cov,cases,chr17,56770074,56770074,0.0,0,147,147
SRR25023302_1_val_1_bismark_bt2_pe.bismark.cov,cases,chr17,56770093,56770093,0.0,0,148,148
SRR25023302_1_val_1_bismark_bt2_pe.bismark.cov,cases,chr17,59940970,59940970,1.06157112526539,5,466,471
SRR25023302_1_val_1_bismark_bt2_pe.bismark.cov,cases,chr17,59940975,59940975,1.06157112526539,5,466,471
SRR25023302_1_val_1_bismark_bt2_pe.bismark.cov,cases,chr17,59940988,59940988,0.425531914893617,2,468,470
SRR25023302_1_val_1_bismark_bt2_pe.bismark.cov,cases,chr17,59940997,59940997,0.869565217391304,4,456,460
SRR25023302_1_val_1_bismark_bt2_pe.bismark.cov,cases,chr17,59941017,59941017,0.0,0,274,274
SRR25023302_1_val_1_bismark_bt2_pe.bismark.cov,cases,chr17,59941051,59941051,0.0,0,465,465
SRR25023302_1_val_1_bismark_bt2_pe.bismark.cov,cases,chr17,59941053,59941053,1.74418604651163,9,507,516
SRR25023302_1_val_1_bismark_bt2_pe.bismark.cov,cases,chr17,59941056,59941056,0.0,0,463,463
SRR25023302_1_val_1_bismark_bt2_pe.bismark.cov,cases,chr17,59941067,59941067,0.213219616204691,1,468,469
SRR25023302_1_val_1_bismark_bt2_pe.bismark.cov,cases,chr17,59941110,59941110,0.568181818181818,3,525,528
SRR25023302_1_val_1_bismark_bt2_pe.bismark.cov,cases,chr17,59941133,59941133,0.943396226415094,5,525,530
SRR25023302_1_val_1_bismark_bt2_pe.bismark.cov,cases,chr17,59941136,59941136,0.189035916824197,1,528,529
SRR25023302_1_val_1_bismark_bt2_pe.bismark.cov,cases,chr17,59941187,59941187,0.378787878787879,2,526,528
SRR25023302_1_val_1_bismark_bt2_pe.bismark.cov,cases,chr17,59941191,59941191,0.378071833648393,2,527,529
SRR25023302_1_val_1_bismark_bt2_pe.bismark.cov,cases,chr17,59941201,59941201,0.97323600973236,4,407,411
SRR25023302_1_val_1_bismark_bt2_pe.bismark.cov,cases,chr17,59941202,59941202,0.0,0,105,105
SRR25023302_1_val_1_bismark_bt2_pe.bismark.cov,cases,chr17,76325846,76325846,54.7169811320755,29,24,53
SRR25023302_1_val_1_bismark_bt2_pe.bismark.cov,cases,chr17,76325851,76325851,41.5094339622642,22,31,53
SRR25023302_1_val_1_bismark_bt2_pe.bismark.cov,cases,chr17,76325865,76325865,33.9622641509434,18,35,53
SRR25023302_1_val_1_bismark_bt2_pe.bismark.cov,cases,chr17,76325979,76325979,67.9245283018868,36,17,53
SRR25023302_1_val_1_bismark_bt2_pe.bismark.cov,cases,chr8,30890012,30890012,59.7058823529412,203,137,340
SRR25023302_1_val_1_bismark_bt2_pe.bismark.cov,cases,chr8,30890034,30890034,68.75,231,105,336
SRR25023302_1_val_1_bismark_bt2_pe.bismark.cov,cases,chr8,30890051,30890051,97.6047904191617,326,8,334
SRR25023302_1_val_1_bismark_bt2_pe.bismark.cov,cases,chr8,30890057,30890057,82.0359281437126,274,60,334
SRR25023302_1_val_1_bismark_bt2_pe.bismark.cov,cases,chr8,30890073,30890073,53.7537537537538,179,154,333
SRR25023302_1_val_1_bismark_bt2_pe.bismark.cov,cases,chr8,30890108,30890108,17.2727272727273,57,273,330
SRR25023302_1_val_1_bismark_bt2_pe.bismark.cov,cases,chr8,30890133,30890133,26.5060240963855,88,244,332
SRR25023302_1_val_1_bismark_bt2_pe.bismark.cov,cases,chr8,30890139,30890139,48.6404833836858,161,170,331
SRR25023302_1_val_1_bismark_bt2_pe.bismark.cov,cases,chr8,30890145,30890145,14.3712574850299,48,286,334
SRR25023302_1_val_1_bismark_bt2_pe.bismark.cov,cases,chr8,30890170,30890170,18.2634730538922,61,273,334
SRR25023302_1_val_1_bismark_bt2_pe.bismark.cov,cases,chr8,30890172,30890172,15.7099697885196,52,279,331
SRR25023302_1_val_1_bismark_bt2_pe.bismark.cov,cases,chr8,90997245,90997245,14.1304347826087,13,79,92
SRR25023302_1_val_1_bismark_bt2_pe.bismark.cov,cases,chr8,90997299,90997299,0.0,0,91,91
SRR25023302_1_val_1_bismark_bt2_pe.bismark.cov,cases,chr8,90997454,90997454,20.0,16,64,80
SRR25023302_1_val_1_bismark_bt2_pe.bismark.cov,cases,chr8,90997482,90997482,96.3855421686747,80,3,83
SRR25023302_1_val_1_bismark_bt2_pe.bismark.cov,cases,chr15,89786999,89786999,1.70940170940171,4,230,234
SRR25023302_1_val_1_bismark_bt2_pe.bismark.cov,cases,chr15,89787007,89787007,0.4149377593361,1,240,241
SRR25023302_1_val_1_bismark_bt2_pe.bismark.cov,cases,chr15,89787009,89787009,1.2448132780083,3,238,241
SRR25023302_1_val_1_bismark_bt2_pe.bismark.cov,cases,chr15,89787018,89787018,0.413223140495868,1,241,242
SRR25023302_1_val_1_bismark_bt2_pe.bismark.cov,cases,chr15,89787032,89787032,1.2448132780083,3,238,241
SRR25023302_1_val_1_bismark_bt2_pe.bismark.cov,cases,chr15,89787034,89787034,0.4149377593361,1,240,241
SRR25023302_1_val_1_bismark_bt2_pe.bismark.cov,cases,chr15,89787036,89787036,0.833333333333333,2,238,240
SRR25023302_1_val_1_bismark_bt2_pe.bismark.cov,cases,chr15,89787045,89787045,0.0,0,242,242
SRR25023302_1_val_1_bismark_bt2_pe.bismark.cov,cases,chr15,89787048,89787048,0.826446280991736,2,240,242
SRR25023302_1_val_1_bismark_bt2_pe.bismark.cov,cases,chr15,89787058,89787058,1.2396694214876,3,239,242
SRR25023302_1_val_1_bismark_bt2_pe.bismark.cov,cases,chr15,89787060,89787060,1.2396694214876,3,239,242
SRR25023302_1_val_1_bismark_bt2_pe.bismark.cov,cases,chr15,89787066,89787066,0.4149377593361,1,240,241
SRR25023302_1_val_1_bismark_bt2_pe.bismark.cov,cases,chr15,89787077,89787077,0.413223140495868,1,241,242
SRR25023302_1_val_1_bismark_bt2_pe.bismark.cov,cases,chr15,89787087,89787087,0.416666666666667,1,239,240
SRR25023302_1_val_1_bismark_bt2_pe.bismark.cov,cases,chr15,89787103,89787103,0.0,0,238,238
SRR25023302_1_val_1_bismark_bt2_pe.bismark.cov,cases,chr15,89787109,89787109,0.843881856540084,2,235,237
SRR25023302_1_val_1_bismark_bt2_pe.bismark.cov,cases,chr15,89787113,89787113,0.0,0,237,237
SRR25023302_1_val_1_bismark_bt2_pe.bismark.cov,cases,chr15,89787120,89787120,0.0,0,238,238
SRR25023302_1_val_1_bismark_bt2_pe.bismark.cov,cases,chr15,89787150,89787150,1.28755364806867,3,230,233
SRR25023302_1_val_1_bismark_bt2_pe.bismark.cov,cases,chr15,89787154,89787154,0.862068965517241,2,230,232
SRR25023302_1_val_1_bismark_bt2_pe.bismark.cov,cases,chr15,89787164,89787164,0.0,0,232,232
SRR25023302_1_val_1_bismark_bt2_pe.bismark.cov,cases,chr15,89787168,89787168,0.0,0,232,232
SRR25023302_1_val_1_bismark_bt2_pe.bismark.cov,cases,chr15,89787171,89787171,0.434782608695652,1,229,230
SRR25023302_1_val_1_bismark_bt2_pe.bismark.cov,cases,chr15,89787182,89787182,0.873362445414847,2,227,229
SRR25023302_1_val_1_bismark_bt2_pe.bismark.cov,cases,chr15,89787184,89787184,0.0,0,227,227
SRR25023302_1_val_1_bismark_bt2_pe.bismark.cov,cases,chr15,89787190,89787190,0.0,0,223,223
SRR25023302_1_val_1_bismark_bt2_pe.bismark.cov,cases,chr15,89787205,89787205,0.0,0,201,201
SRR25023302_1_val_1_bismark_bt2_pe.bismark.cov,cases,chr15,89787212,89787212,1.23456790123457,2,160,162
SRR25023302_1_val_1_bismark_bt2_pe.bismark.cov,cases,chr15,89787223,89787223,0.0,0,126,126
SRR25023302_1_val_1_bismark_bt2_pe.bismark.cov,cases,chr15,89787226,89787226,0.757575757575758,1,131,132
SRR25023302_1_val_1_bismark_bt2_pe.bismark.cov,cases,chr15,89787238,89787238,0.0,0,144,144
SRR25023302_1_val_1_bismark_bt2_pe.bismark.cov,cases,chr15,89787260,89787260,0.578034682080925,1,172,173
SRR25023302_1_val_1_bismark_bt2_pe.bismark.cov,cases,chr15,89787272,89787272,0.568181818181818,1,175,176
SRR25023302_1_val_1_bismark_bt2_pe.bismark.cov,cases,chr15,89787288,89787288,0.0,0,205,205
SRR25023302_1_val_1_bismark_bt2_pe.bismark.cov,cases,chr15,89787293,89787293,0.0,0,211,211
SRR25023302_1_val_1_bismark_bt2_pe.bismark.cov,cases,chr15,89787295,89787295,0.956937799043062,2,207,209
SRR25023302_1_val_1_bismark_bt2_pe.bismark.cov,cases,chr15,89787304,89787304,0.0,0,222,222
SRR25023302_1_val_1_bismark_bt2_pe.bismark.cov,cases,chr15,89787335,89787335,0.0,0,236,236
SRR25023302_1_val_1_bismark_bt2_pe.bismark.cov,cases,chr14,45604787,45604787,0.740740740740741,4,536,540
SRR25023302_1_val_1_bismark_bt2_pe.bismark.cov,cases,chr14,45604794,45604794,0.185185185185185,1,539,540
SRR25023302_1_val_1_bismark_bt2_pe.bismark.cov,cases,chr16,23652769,23652769,0.133511348464619,1,748,749
SRR25023302_1_val_1_bismark_bt2_pe.bismark.cov,cases,chr16,23652783,23652783,1.59362549800797,12,741,753
SRR25023302_1_val_1_bismark_bt2_pe.bismark.cov,cases,chr16,23652787,23652787,0.666666666666667,5,745,750
SRR25023302_1_val_1_bismark_bt2_pe.bismark.cov,cases,chr16,23652797,23652797,0.402684563758389,3,742,745
SRR25023302_1_val_1_bismark_bt2_pe.bismark.cov,cases,chr16,23652818,23652818,0.404858299595142,3,738,741
SRR25023302_1_val_1_bismark_bt2_pe.bismark.cov,cases,chr16,23652838,23652838,0.269541778975741,2,740,742
SRR25023302_1_val_1_bismark_bt2_pe.bismark.cov,cases,chr16,23652857,23652857,0.661375661375661,5,751,756
SRR25023302_1_val_1_bismark_bt2_pe.bismark.cov,cases,chr16,23652860,23652860,0.264550264550265,2,754,756
SRR25023302_1_val_1_bismark_bt2_pe.bismark.cov,cases,chr16,23652876,23652876,0.660501981505945,5,752,757
SRR25023302_1_val_1_bismark_bt2_pe.bismark.cov,cases,chr16,23652906,23652906,0.927152317880795,7,748,755
SRR25023302_1_val_1_bismark_bt2_pe.bismark.cov,cases,chr16,23652911,23652911,0.794701986754967,6,749,755
SRR25023302_1_val_1_bismark_bt2_pe.bismark.cov,cases,chr16,23652916,23652916,0.94722598105548,7,732,739
SRR25023302_1_val_1_bismark_bt2_pe.bismark.cov,cases,chr16,23652918,23652918,1.19363395225464,9,745,754
SRR25023302_1_val_1_bismark_bt2_pe.bismark.cov,cases,chr7,6048860,6048860,0.0,0,23,23
SRR25023302_1_val_1_bismark_bt2_pe.bismark.cov,cases,chr7,6048869,6048869,0.41371158392435,21,5055,5076
SRR25023302_1_val_1_bismark_bt2_pe.bismark.cov,cases,chr7,6048876,6048876,0.27564481197086,14,5065,5079
SRR25023302_1_val_1_bismark_bt2_pe.bismark.cov,cases,chr7,6048884,6048884,0.513630975898854,26,5036,5062
SRR25023302_1_val_1_bismark_bt2_pe.bismark.cov,cases,chr7,6048888,6048888,0.335769306735137,17,5046,5063
SRR25023302_1_val_1_bismark_bt2_pe.bismark.cov,cases,chr7,6048892,6048892,0.41403785488959,21,5051,5072
SRR25023302_1_val_1_bismark_bt2_pe.bismark.cov,cases,chr7,6048904,6048904,0.0,0,1034,1034
SRR25023302_1_val_1_bismark_bt2_pe.bismark.cov,cases,chr7,6048918,6048918,0.608798114689709,31,5061,5092
SRR25023302_1_val_1_bismark_bt2_pe.bismark.cov,cases,chr7,6048925,6048925,0.353218210361068,18,5078,5096
SRR25023302_1_val_1_bismark_bt2_pe.bismark.cov,cases,chr7,6048928,6048928,0.686543742644174,35,5063,5098
SRR25023302_1_val_1_bismark_bt2_pe.bismark.cov,cases,chr7,6048940,6048940,0.392387679026879,20,5077,5097
SRR25023302_1_val_1_bismark_bt2_pe.bismark.cov,cases,chr7,6048951,6048951,0.274725274725275,14,5082,5096
SRR25023302_1_val_1_bismark_bt2_pe.bismark.cov,cases,chr7,6048966,6048966,0.451157316594743,23,5075,5098
SRR25023302_1_val_1_bismark_bt2_pe.bismark.cov,cases,chr7,6048968,6048968,0.492416781563916,25,5052,5077
SRR25023302_1_val_1_bismark_bt2_pe.bismark.cov,cases,chrX,14891454,14891454,20.8653846153846,651,2469,3120
SRR25023302_1_val_1_bismark_bt2_pe.bismark.cov,cases,chrX,14891470,14891470,16.448,514,2611,3125
SRR25023302_1_val_1_bismark_bt2_pe.bismark.cov,cases,chrX,14891474,14891474,26.5345268542199,830,2298,3128
SRR25023302_1_val_1_bismark_bt2_pe.bismark.cov,cases,chrX,14891488,14891488,38.5723431498079,1205,1919,3124
SRR25023302_1_val_1_bismark_bt2_pe.bismark.cov,cases,chrX,14891493,14891493,44.5332480818414,1393,1735,3128
SRR25023302_1_val_1_bismark_bt2_pe.bismark.cov,cases,chrX,14891496,14891496,25.5925688661115,799,2323,3122
SRR25023302_1_val_1_bismark_bt2_pe.bismark.cov,cases,chrX,14891499,14891499,17.696,553,2572,3125
SRR25023302_1_val_1_bismark_bt2_pe.bismark.cov,cases,chrX,14891509,14891509,44.49423815621,1390,1734,3124
SRR25023302_1_val_1_bismark_bt2_pe.bismark.cov,cases,chrX,14891516,14891516,37.0642788615286,1159,1968,3127
SRR25023302_1_val_1_bismark_bt2_pe.bismark.cov,cases,chrX,14891524,14891524,35.3241775790482,1106,2025,3131
SRR25023302_1_val_1_bismark_bt2_pe.bismark.cov,cases,chrX,14891526,14891526,31.3856960408685,983,2149,3132
SRR25023302_1_val_1_bismark_bt2_pe.bismark.cov,cases,chrX,14891530,14891530,37.9244074311339,1184,1938,3122
SRR25023302_1_val_1_bismark_bt2_pe.bismark.cov,cases,chr22,29137950,29137950,0.0,0,61,61
SRR25023302_1_val_1_bismark_bt2_pe.bismark.cov,cases,chr22,29137964,29137964,0.0,0,53,53
SRR25023302_1_val_1_bismark_bt2_pe.bismark.cov,cases,chr22,29137975,29137975,0.0,0,52,52
SRR25023302_1_val_1_bismark_bt2_pe.bismark.cov,cases,chr22,29137985,29137985,0.0,0,39,39
SRR25023302_1_val_1_bismark_bt2_pe.bismark.cov,cases,chr22,29137993,29137993,0.0,0,33,33
SRR25023302_1_val_1_bismark_bt2_pe.bismark.cov,cases,chr22,29138031,29138031,1.75438596491228,1,56,57
SRR25023302_1_val_1_bismark_bt2_pe.bismark.cov,cases,chr22,29138052,29138052,0.0,0,60,60
SRR25023302_1_val_1_bismark_bt2_pe.bismark.cov,cases,chr22,29138062,29138062,0.0,0,60,60
SRR25023302_1_val_1_bismark_bt2_pe.bismark.cov,cases,chr22,29138075,29138075,1.66666666666667,1,59,60
SRR25023302_1_val_1_bismark_bt2_pe.bismark.cov,cases,chr22,29138078,29138078,1.69491525423729,1,58,59
SRR25023302_1_val_1_bismark_bt2_pe.bismark.cov,cases,chr22,29138091,29138091,0.0,0,53,53
SRR25023302_1_val_1_bismark_bt2_pe.bismark.cov,cases,chr22,29138102,29138102,0.0,0,60,60
SRR25023302_1_val_1_bismark_bt2_pe.bismark.cov,cases,chr22,29138115,29138115,0.0,0,59,59
SRR25023302_1_val_1_bismark_bt2_pe.bismark.cov,cases,chr22,29138134,29138134,0.0,0,60,60
SRR25023302_1_val_1_bismark_bt2_pe.bismark.cov,cases,chr22,29138158,29138158,1.61290322580645,1,61,62
SRR25023302_1_val_1_bismark_bt2_pe.bismark.cov,cases,chr22,29138168,29138168,0.0,0,61,61
SRR25023302_1_val_1_bismark_bt2_pe.bismark.cov,cases,chr22,29138176,29138176,1.63934426229508,1,60,61
SRR25023302_1_val_1_bismark_bt2_pe.bismark.cov,cases,chr22,29138179,29138179,0.0,0,62,62
SRR25023302_1_val_1_bismark_bt2_pe.bismark.cov,cases,chr22,29138185,29138185,0.0,0,63,63
SRR25023302_1_val_1_bismark_bt2_pe.bismark.cov,cases,chr22,29138202,29138202,1.63934426229508,1,60,61
SRR25023302_1_val_1_bismark_bt2_pe.bismark.cov,cases,chr22,29138216,29138216,1.61290322580645,1,61,62
SRR25023302_1_val_1_bismark_bt2_pe.bismark.cov,cases,chr22,29138219,29138219,0.0,0,62,62
SRR25023302_1_val_1_bismark_bt2_pe.bismark.cov,cases,chr22,29138234,29138234,0.0,0,62,62
SRR25023302_1_val_1_bismark_bt2_pe.bismark.cov,cases,chr22,29138238,29138238,0.0,0,61,61
SRR25023303_1_val_1_bismark_bt2_pe.bismark.cov,cases,chr3,37034307,37034307,99.8483469821049,3292,5,3297
SRR25023303_1_val_1_bismark_bt2_pe.bismark.cov,cases,chr3,37034316,37034316,0.637135922330097,21,3275,3296
SRR25023303_1_val_1_bismark_bt2_pe.bismark.cov,cases,chr3,37034324,37034324,0.272975432211101,9,3288,3297
SRR25023303_1_val_1_bismark_bt2_pe.bismark.cov,cases,chr3,37034330,37034330,0.878787878787879,29,3271,3300
SRR25023303_1_val_1_bismark_bt2_pe.bismark.cov,cases,chr3,37034344,37034344,0.637135922330097,21,3275,3296
SRR25023303_1_val_1_bismark_bt2_pe.bismark.cov,cases,chr3,37034346,37034346,0.515151515151515,17,3283,3300
SRR25023303_1_val_1_bismark_bt2_pe.bismark.cov,cases,chr3,37034348,37034348,0.333636639369123,11,3286,3297
SRR25023303_1_val_1_bismark_bt2_pe.bismark.cov,cases,chr3,37034352,37034352,0.605877006967586,20,3281,3301
SRR25023303_1_val_1_bismark_bt2_pe.bismark.cov,cases,chr3,37034355,37034355,0.423985463355542,14,3288,3302
SRR25023303_1_val_1_bismark_bt2_pe.bismark.cov,cases,chr3,37034359,37034359,0.272644653135414,9,3292,3301
SRR25023303_1_val_1_bismark_bt2_pe.bismark.cov,cases,chr3,37034369,37034369,0.652579241765072,21,3197,3218
SRR25023303_1_val_1_bismark_bt2_pe.bismark.cov,cases,chr3,37034373,37034373,0.39417828987265,13,3285,3298
SRR25023303_1_val_1_bismark_bt2_pe.bismark.cov,cases,chr3,37034382,37034382,0.576106731352335,19,3279,3298
SRR25023303_1_val_1_bismark_bt2_pe.bismark.cov,cases,chr3,37034394,37034394,0.393939393939394,13,3287,3300
SRR25023303_1_val_1_bismark_bt2_pe.bismark.cov,cases,chr3,37034402,37034402,0.363856882959369,12,3286,3298
SRR25023303_1_val_1_bismark_bt2_pe.bismark.cov,cases,chr3,37034409,37034409,0.424371021521673,14,3285,3299
SRR25023303_1_val_1_bismark_bt2_pe.bismark.cov,cases,chr3,37034412,37034412,0.605877006967586,20,3281,3301
SRR25023303_1_val_1_bismark_bt2_pe.bismark.cov,cases,chr3,37034414,37034414,0.454545454545455,15,3285,3300
SRR25023303_1_val_1_bismark_bt2_pe.bismark.cov,cases,chr3,37034418,37034418,0.24264482863209,8,3289,3297
SRR25023303_1_val_1_bismark_bt2_pe.bismark.cov,cases,chr3,37034420,37034420,0.182038834951456,6,3290,3296
SRR25023303_1_val_1_bismark_bt2_pe.bismark.cov,cases,chr3,37034430,37034430,0.515463917525773,17,3281,3298
SRR25023303_1_val_1_bismark_bt2_pe.bismark.cov,cases,chr3,37034438,37034438,0.212378640776699,7,3289,3296
SRR25023303_1_val_1_bismark_bt2_pe.bismark.cov,cases,chr3,37034441,37034441,0.485436893203883,16,3280,3296
SRR25023303_1_val_1_bismark_bt2_pe.bismark.cov,cases,chr3,37034466,37034466,99.9390801096558,3281,2,3283
SRR25023303_1_val_1_bismark_bt2_pe.bismark.cov,cases,chr3,37034997,37034997,0.323947171692001,13,4000,4013
SRR25023303_1_val_1_bismark_bt2_pe.bismark.cov,cases,chr3,37035012,37035012,0.298953662182362,12,4002,4014
SRR25023303_1_val_1_bismark_bt2_pe.bismark.cov,cases,chr3,37035032,37035032,0.274040857000498,11,4003,4014
SRR25023303_1_val_1_bismark_bt2_pe.bismark.cov,cases,chr3,37035043,37035043,0.273699925354566,11,4008,4019
SRR25023303_1_val_1_bismark_bt2_pe.bismark.cov,cases,chr3,37035047,37035047,0.273768043802887,11,4007,4018
SRR25023303_1_val_1_bismark_bt2_pe.bismark.cov,cases,chr3,37035063,37035063,0.199104031856645,8,4010,4018
SRR25023303_1_val_1_bismark_bt2_pe.bismark.cov,cases,chr3,37035066,37035066,0.373412994772218,15,4002,4017
SRR25023303_1_val_1_bismark_bt2_pe.bismark.cov,cases,chr3,37035074,37035074,0.27431421446384,11,3999,4010
SRR25023303_1_val_1_bismark_bt2_pe.bismark.cov,cases,chr3,37035090,37035090,0.598503740648379,24,3986,4010
SRR25023303_1_val_1_bismark_bt2_pe.bismark.cov,cases,chr3,37035095,37035095,0.324189526184539,13,3997,4010
SRR25023303_1_val_1_bismark_bt2_pe.bismark.cov,cases,chr3,37035097,37035097,0.348779272546089,14,4000,4014
SRR25023303_1_val_1_bismark_bt2_pe.bismark.cov,cases,chr3,37035100,37035100,0.323866467364225,13,4001,4014
SRR25023303_1_val_1_bismark_bt2_pe.bismark.cov,cases,chr3,37035117,37035117,0.323947171692001,13,4000,4013
SRR25023303_1_val_1_bismark_bt2_pe.bismark.cov,cases,chr3,142297977,142297977,0.62667860340197,7,1110,1117
SRR25023303_1_val_1_bismark_bt2_pe.bismark.cov,cases,chr3,142298019,142298019,0.893655049151028,10,1109,1119
SRR25023303_1_val_1_bismark_bt2_pe.bismark.cov,cases,chr3,142298045,142298045,0.894454382826476,10,1108,1118
SRR25023303_1_val_1_bismark_bt2_pe.bismark.cov,cases,chr3,142298054,142298054,3.6003600360036,40,1071,1111
SRR25023303_1_val_1_bismark_bt2_pe.bismark.cov,cases,chr13,32889392,32889392,14.7537227949599,644,3721,4365
SRR25023303_1_val_1_bismark_bt2_pe.bismark.cov,cases,chr13,32889434,32889434,1.49322306455318,65,4288,4353
SRR25023303_1_val_1_bismark_bt2_pe.bismark.cov,cases,chr13,32889461,32889461,0.345224395857307,15,4330,4345
SRR25023303_1_val_1_bismark_bt2_pe.bismark.cov,cases,chr13,32889470,32889470,0.206801470588235,9,4343,4352
SRR25023303_1_val_1_bismark_bt2_pe.bismark.cov,cases,chr13,32889484,32889484,0.321765111468628,14,4337,4351
SRR25023303_1_val_1_bismark_bt2_pe.bismark.cov,cases,chr13,108867034,108867034,46.9059405940594,379,429,808
SRR25023303_1_val_1_bismark_bt2_pe.bismark.cov,cases,chr13,108867044,108867044,61.5667074663403,503,314,817
SRR25023303_1_val_1_bismark_bt2_pe.bismark.cov,cases,chr13,108867051,108867051,57.6312576312576,472,347,819
SRR25023303_1_val_1_bismark_bt2_pe.bismark.cov,cases,chr13,108867109,108867109,86.2362971985384,708,113,821
SRR25023303_1_val_1_bismark_bt2_pe.bismark.cov,cases,chr13,108867112,108867112,92.2141119221411,758,64,822
SRR25023303_1_val_1_bismark_bt2_pe.bismark.cov,cases,chr13,108867124,108867124,75.4257907542579,620,202,822
SRR25023303_1_val_1_bismark_bt2_pe.bismark.cov,cases,chr13,108867135,108867135,58.8522588522589,482,337,819
SRR25023303_1_val_1_bismark_bt2_pe.bismark.cov,cases,chr13,108867155,108867155,53.0413625304136,436,386,822
SRR25023303_1_val_1_bismark_bt2_pe.bismark.cov,cases,chr11,108093323,108093323,0.938967136150235,10,1055,1065
SRR25023303_1_val_1_bismark_bt2_pe.bismark.cov,cases,chr11,108093335,108093335,0.281425891181989,3,1063,1066
SRR25023303_1_val_1_bismark_bt2_pe.bismark.cov,cases,chr11,108093338,108093338,0.375586854460094,4,1061,1065
SRR25023303_1_val_1_bismark_bt2_pe.bismark.cov,cases,chr11,108093359,108093359,0.0949667616334283,1,1052,1053
SRR25023303_1_val_1_bismark_bt2_pe.bismark.cov,cases,chr11,108093371,108093371,0.341296928327645,3,876,879
SRR25023303_1_val_1_bismark_bt2_pe.bismark.cov,cases,chr11,108093373,108093373,0.0,0,878,878
SRR25023303_1_val_1_bismark_bt2_pe.bismark.cov,cases,chr11,108093386,108093386,0.455062571103527,4,875,879
SRR25023303_1_val_1_bismark_bt2_pe.bismark.cov,cases,chr11,108093395,108093395,0.11454753722795,1,872,873
SRR25023303_1_val_1_bismark_bt2_pe.bismark.cov,cases,chr11,108093402,108093402,0.345224395857307,3,866,869
SRR25023303_1_val_1_bismark_bt2_pe.bismark.cov,cases,chr11,108093413,108093413,0.348837209302326,3,857,860
SRR25023303_1_val_1_bismark_bt2_pe.bismark.cov,cases,chr11,108093419,108093419,0.0,0,860,860
SRR25023303_1_val_1_bismark_bt2_pe.bismark.cov,cases,chr11,108093436,108093436,0.466200466200466,4,854,858
SRR25023303_1_val_1_bismark_bt2_pe.bismark.cov,cases,chr11,108093439,108093439,0.0,0,860,860
SRR25023303_1_val_1_bismark_bt2_pe.bismark.cov,cases,chr11,108093451,108093451,0.0,0,858,858
SRR25023303_1_val_1_bismark_bt2_pe.bismark.cov,cases,chr11,108093457,108093457,0.233372228704784,2,855,857
SRR25023303_1_val_1_bismark_bt2_pe.bismark.cov,cases,chr11,108093461,108093461,0.699300699300699,6,852,858
SRR25023303_1_val_1_bismark_bt2_pe.bismark.cov,cases,chr11,108093467,108093467,0.0,0,857,857
SRR25023303_1_val_1_bismark_bt2_pe.bismark.cov,cases,chr11,108093476,108093476,0.234192037470726,2,852,854
SRR25023303_1_val_1_bismark_bt2_pe.bismark.cov,cases,chr11,108093485,108093485,0.235571260306243,2,847,849
SRR25023303_1_val_1_bismark_bt2_pe.bismark.cov,cases,chr11,108093505,108093505,0.127226463104326,1,785,786
SRR25023303_1_val_1_bismark_bt2_pe.bismark.cov,cases,chr11,108093520,108093520,0.0,0,631,631
SRR25023303_1_val_1_bismark_bt2_pe.bismark.cov,cases,chr11,108093529,108093529,1.75438596491228,1,56,57
SRR25023303_1_val_1_bismark_bt2_pe.bismark.cov,cases,chr11,108093532,108093532,1.49253731343284,1,66,67
SRR25023303_1_val_1_bismark_bt2_pe.bismark.cov,cases,chr11,108093538,108093538,1.03092783505155,1,96,97
SRR25023303_1_val_1_bismark_bt2_pe.bismark.cov,cases,chr11,108093560,108093560,0.296296296296296,2,673,675
SRR25023303_1_val_1_bismark_bt2_pe.bismark.cov,cases,chr11,108093567,108093567,0.0,0,721,721
SRR25023303_1_val_1_bismark_bt2_pe.bismark.cov,cases,chr11,108093572,108093572,0.0,0,750,750
SRR25023303_1_val_1_bismark_bt2_pe.bismark.cov,cases,chr11,108093579,108093579,0.0,0,769,769
SRR25023303_1_val_1_bismark_bt2_pe.bismark.cov,cases,chr11,108093584,108093584,0.378787878787879,3,789,792
SRR25023303_1_val_1_bismark_bt2_pe.bismark.cov,cases,chr11,108093590,108093590,0.0,0,843,843
SRR25023303_1_val_1_bismark_bt2_pe.bismark.cov,cases,chr11,108093598,108093598,0.582750582750583,5,853,858
SRR25023303_1_val_1_bismark_bt2_pe.bismark.cov,cases,chr6,43543548,43543548,0.869565217391304,4,456,460
SRR25023303_1_val_1_bismark_bt2_pe.bismark.cov,cases,chr6,43543554,43543554,0.434782608695652,2,458,460
SRR25023303_1_val_1_bismark_bt2_pe.bismark.cov,cases,chr6,43543571,43543571,0.437636761487965,2,455,457
SRR25023303_1_val_1_bismark_bt2_pe.bismark.cov,cases,chr6,43543578,43543578,0.433839479392625,2,459,461
SRR25023303_1_val_1_bismark_bt2_pe.bismark.cov,cases,chr6,43543580,43543580,0.217864923747277,1,458,459
SRR25023303_1_val_1_bismark_bt2_pe.bismark.cov,cases,chr6,43543596,43543596,0.0,0,460,460
SRR25023303_1_val_1_bismark_bt2_pe.bismark.cov,cases,chr6,43543608,43543608,0.216919739696312,1,460,461
SRR25023303_1_val_1_bismark_bt2_pe.bismark.cov,cases,chr6,43543613,43543613,0.650759219088937,3,458,461
SRR25023303_1_val_1_bismark_bt2_pe.bismark.cov,cases,chr6,43543615,43543615,0.433839479392625,2,459,461
SRR25023303_1_val_1_bismark_bt2_pe.bismark.cov,cases,chr6,43543618,43543618,0.0,0,460,460
SRR25023303_1_val_1_bismark_bt2_pe.bismark.cov,cases,chr6,43543624,43543624,1.31004366812227,6,452,458
SRR25023303_1_val_1_bismark_bt2_pe.bismark.cov,cases,chr6,43543642,43543642,0.0,0,459,459
SRR25023303_1_val_1_bismark_bt2_pe.bismark.cov,cases,chr6,43543650,43543650,0.0,0,457,457
SRR25023303_1_val_1_bismark_bt2_pe.bismark.cov,cases,chr6,43543657,43543657,0.655021834061135,3,455,458
SRR25023303_1_val_1_bismark_bt2_pe.bismark.cov,cases,chr6,43543669,43543669,0.0,0,458,458
SRR25023303_1_val_1_bismark_bt2_pe.bismark.cov,cases,chr6,43543672,43543672,0.66079295154185,3,451,454
SRR25023303_1_val_1_bismark_bt2_pe.bismark.cov,cases,chr6,43543682,43543682,0.222222222222222,1,449,450
SRR25023303_1_val_1_bismark_bt2_pe.bismark.cov,cases,chr6,43543691,43543691,0.89086859688196,4,445,449
SRR25023303_1_val_1_bismark_bt2_pe.bismark.cov,cases,chr6,43543696,43543696,1.78571428571429,8,440,448
SRR25023303_1_val_1_bismark_bt2_pe.bismark.cov,cases,chr6,43543698,43543698,0.447427293064877,2,445,447
SRR25023303_1_val_1_bismark_bt2_pe.bismark.cov,cases,chr6,43543701,43543701,1.12612612612613,5,439,444
SRR25023303_1_val_1_bismark_bt2_pe.bismark.cov,cases,chr6,43543705,43543705,0.224719101123596,1,444,445
SRR25023303_1_val_1_bismark_bt2_pe.bismark.cov,cases,chr6,43543708,43543708,0.225225225225225,1,443,444
SRR25023303_1_val_1_bismark_bt2_pe.bismark.cov,cases,chr6,43543733,43543733,0.0,0,446,446
SRR25023303_1_val_1_bismark_bt2_pe.bismark.cov,cases,chr6,43543747,43543747,0.223214285714286,1,447,448
SRR25023303_1_val_1_bismark_bt2_pe.bismark.cov,cases,chr6,43543749,43543749,0.669642857142857,3,445,448
SRR25023303_1_val_1_bismark_bt2_pe.bismark.cov,cases,chr6,43543763,43543763,0.464037122969838,2,429,431
SRR25023303_1_val_1_bismark_bt2_pe.bismark.cov,cases,chr6,43543766,43543766,0.0,0,427,427
SRR25023303_1_val_1_bismark_bt2_pe.bismark.cov,cases,chr6,43543771,43543771,0.0,0,435,435
SRR25023303_1_val_1_bismark_bt2_pe.bismark.cov,cases,chr6,43543775,43543775,0.464037122969838,2,429,431
SRR25023303_1_val_1_bismark_bt2_pe.bismark.cov,cases,chr6,43543777,43543777,0.466200466200466,2,427,429
SRR25023303_1_val_1_bismark_bt2_pe.bismark.cov,cases,chr6,43543781,43543781,0.232018561484919,1,430,431
SRR25023303_1_val_1_bismark_bt2_pe.bismark.cov,cases,chr6,43543786,43543786,0.229885057471264,1,434,435
SRR25023303_1_val_1_bismark_bt2_pe.bismark.cov,cases,chr6,43543794,43543794,0.455580865603645,2,437,439
SRR25023303_1_val_1_bismark_bt2_pe.bismark.cov,cases,chr6,43543798,43543798,0.681818181818182,3,437,440
SRR25023303_1_val_1_bismark_bt2_pe.bismark.cov,cases,chr6,43543800,43543800,0.226757369614512,1,440,441
SRR25023303_1_val_1_bismark_bt2_pe.bismark.cov,cases,chr6,43543804,43543804,0.451467268623025,2,441,443
SRR25023303_1_val_1_bismark_bt2_pe.bismark.cov,cases,chr6,43543806,43543806,0.451467268623025,2,441,443
SRR25023303_1_val_1_bismark_bt2_pe.bismark.cov,cases,chr6,43543815,43543815,0.0,0,441,441
SRR25023303_1_val_1_bismark_bt2_pe.bismark.cov,cases,chr6,43543822,43543822,0.452488687782805,2,440,442
SRR25023303_1_val_1_bismark_bt2_pe.bismark.cov,cases,chr2,47596828,47596828,3.6073329390893,61,1630,1691
SRR25023303_1_val_1_bismark_bt2_pe.bismark.cov,cases,chr2,47596830,47596830,4.60104834012813,79,1638,1717
SRR25023303_1_val_1_bismark_bt2_pe.bismark.cov,cases,chr2,47596840,47596840,4.30232558139535,74,1646,1720
SRR25023303_1_val_1_bismark_bt2_pe.bismark.cov,cases,chr2,47596849,47596849,21.9058686809994,377,1344,1721
SRR25023303_1_val_1_bismark_bt2_pe.bismark.cov,cases,chr2,47596853,47596853,6.63176265270506,114,1605,1719
SRR25023303_1_val_1_bismark_bt2_pe.bismark.cov,cases,chr2,47596858,47596858,10.9112013929193,188,1535,1723
SRR25023303_1_val_1_bismark_bt2_pe.bismark.cov,cases,chr2,47596862,47596862,10.68524970964,184,1538,1722
SRR25023303_1_val_1_bismark_bt2_pe.bismark.cov,cases,chr2,47596869,47596869,25.2753623188406,436,1289,1725
SRR25023303_1_val_1_bismark_bt2_pe.bismark.cov,cases,chr2,47596883,47596883,18.4561810795125,318,1405,1723
SRR25023303_1_val_1_bismark_bt2_pe.bismark.cov,cases,chr2,47596885,47596885,2.84552845528455,49,1673,1722
SRR25023303_1_val_1_bismark_bt2_pe.bismark.cov,cases,chr2,47596887,47596887,6.38051044083527,110,1614,1724
SRR25023303_1_val_1_bismark_bt2_pe.bismark.cov,cases,chr2,47596897,47596897,6.14492753623188,106,1619,1725
SRR25023303_1_val_1_bismark_bt2_pe.bismark.cov,cases,chr2,47596900,47596900,4.41603718768158,76,1645,1721
SRR25023303_1_val_1_bismark_bt2_pe.bismark.cov,cases,chr2,47596907,47596907,2.20801859384079,38,1683,1721
SRR25023303_1_val_1_bismark_bt2_pe.bismark.cov,cases,chr2,47596912,47596912,3.37013364323068,58,1663,1721
SRR25023303_1_val_1_bismark_bt2_pe.bismark.cov,cases,chr2,47596930,47596930,6.96864111498258,120,1602,1722
SRR25023303_1_val_1_bismark_bt2_pe.bismark.cov,cases,chr2,47596942,47596942,6.28637951105937,108,1610,1718
SRR25023303_1_val_1_bismark_bt2_pe.bismark.cov,cases,chr2,47630224,47630224,0.795947901591896,11,1371,1382
SRR25023303_1_val_1_bismark_bt2_pe.bismark.cov,cases,chr2,47630227,47630227,0.425531914893617,6,1404,1410
SRR25023303_1_val_1_bismark_bt2_pe.bismark.cov,cases,chr2,47630233,47630233,0.496102055279943,7,1404,1411
SRR25023303_1_val_1_bismark_bt2_pe.bismark.cov,cases,chr2,47630237,47630237,0.283687943262411,4,1406,1410
SRR25023303_1_val_1_bismark_bt2_pe.bismark.cov,cases,chr2,47630240,47630240,0.283687943262411,4,1406,1410
SRR25023303_1_val_1_bismark_bt2_pe.bismark.cov,cases,chr2,47630244,47630244,0.568585643212509,8,1399,1407
SRR25023303_1_val_1_bismark_bt2_pe.bismark.cov,cases,chr2,47630251,47630251,0.283687943262411,4,1406,1410
SRR25023303_1_val_1_bismark_bt2_pe.bismark.cov,cases,chr2,47630265,47630265,0.497866287339972,7,1399,1406
SRR25023303_1_val_1_bismark_bt2_pe.bismark.cov,cases,chr2,47630292,47630292,0.354358610914245,5,1406,1411
SRR25023303_1_val_1_bismark_bt2_pe.bismark.cov,cases,chr2,47630294,47630294,0.141743444365698,2,1409,1411
SRR25023303_1_val_1_bismark_bt2_pe.bismark.cov,cases,chr2,128051674,128051674,0.0,0,268,268
SRR25023303_1_val_1_bismark_bt2_pe.bismark.cov,cases,chr2,128051690,128051690,0.440528634361234,4,904,908
SRR25023303_1_val_1_bismark_bt2_pe.bismark.cov,cases,chr2,128051704,128051704,0.110253583241455,1,906,907
SRR25023303_1_val_1_bismark_bt2_pe.bismark.cov,cases,chr2,128051707,128051707,0.110497237569061,1,904,905
SRR25023303_1_val_1_bismark_bt2_pe.bismark.cov,cases,chr2,128051709,128051709,0.441501103752759,4,902,906
SRR25023303_1_val_1_bismark_bt2_pe.bismark.cov,cases,chr2,128051716,128051716,0.0,0,904,904
SRR25023303_1_val_1_bismark_bt2_pe.bismark.cov,cases,chr2,128051733,128051733,0.220507166482911,2,905,907
SRR25023303_1_val_1_bismark_bt2_pe.bismark.cov,cases,chr2,128051743,128051743,0.66079295154185,6,902,908
SRR25023303_1_val_1_bismark_bt2_pe.bismark.cov,cases,chr2,178787742,178787742,93.9890710382514,516,33,549
SRR25023303_1_val_1_bismark_bt2_pe.bismark.cov,cases,chr10,89619506,89619506,96.9230769230769,1386,44,1430
SRR25023303_1_val_1_bismark_bt2_pe.bismark.cov,cases,chr10,89619510,89619510,98.6043265875785,1413,20,1433
SRR25023303_1_val_1_bismark_bt2_pe.bismark.cov,cases,chr10,89619512,89619512,98.1171548117155,1407,27,1434
SRR25023303_1_val_1_bismark_bt2_pe.bismark.cov,cases,chr10,89619522,89619522,97.7793199167245,1409,32,1441
SRR25023303_1_val_1_bismark_bt2_pe.bismark.cov,cases,chr10,89619550,89619550,96.7315716272601,1391,47,1438
SRR25023303_1_val_1_bismark_bt2_pe.bismark.cov,cases,chr10,89619555,89619555,96.3863794301598,1387,52,1439
SRR25023303_1_val_1_bismark_bt2_pe.bismark.cov,cases,chr10,89619566,89619566,94.8503827418233,1363,74,1437
SRR25023303_1_val_1_bismark_bt2_pe.bismark.cov,cases,chr10,89619580,89619580,92.8122819260293,1330,103,1433
SRR25023303_1_val_1_bismark_bt2_pe.bismark.cov,cases,chr15,89786999,89786999,0.48780487804878,1,204,205
SRR25023303_1_val_1_bismark_bt2_pe.bismark.cov,cases,chr15,89787007,89787007,0.956937799043062,2,207,209
SRR25023303_1_val_1_bismark_bt2_pe.bismark.cov,cases,chr15,89787009,89787009,0.478468899521531,1,208,209
SRR25023303_1_val_1_bismark_bt2_pe.bismark.cov,cases,chr15,89787018,89787018,0.0,0,210,210
SRR25023303_1_val_1_bismark_bt2_pe.bismark.cov,cases,chr15,89787032,89787032,0.476190476190476,1,209,210
SRR25023303_1_val_1_bismark_bt2_pe.bismark.cov,cases,chr15,89787034,89787034,0.476190476190476,1,209,210
SRR25023303_1_val_1_bismark_bt2_pe.bismark.cov,cases,chr15,89787036,89787036,0.476190476190476,1,209,210
SRR25023303_1_val_1_bismark_bt2_pe.bismark.cov,cases,chr15,89787045,89787045,0.478468899521531,1,208,209
SRR25023303_1_val_1_bismark_bt2_pe.bismark.cov,cases,chr15,89787048,89787048,0.952380952380952,2,208,210
SRR25023303_1_val_1_bismark_bt2_pe.bismark.cov,cases,chr15,89787058,89787058,0.478468899521531,1,208,209
SRR25023303_1_val_1_bismark_bt2_pe.bismark.cov,cases,chr15,89787060,89787060,0.476190476190476,1,209,210
SRR25023303_1_val_1_bismark_bt2_pe.bismark.cov,cases,chr15,89787066,89787066,0.0,0,210,210
SRR25023303_1_val_1_bismark_bt2_pe.bismark.cov,cases,chr15,89787077,89787077,0.478468899521531,1,208,209
SRR25023303_1_val_1_bismark_bt2_pe.bismark.cov,cases,chr15,89787087,89787087,0.0,0,209,209
SRR25023303_1_val_1_bismark_bt2_pe.bismark.cov,cases,chr15,89787103,89787103,0.0,0,208,208
SRR25023303_1_val_1_bismark_bt2_pe.bismark.cov,cases,chr15,89787109,89787109,0.0,0,206,206
SRR25023303_1_val_1_bismark_bt2_pe.bismark.cov,cases,chr15,89787113,89787113,0.970873786407767,2,204,206
SRR25023303_1_val_1_bismark_bt2_pe.bismark.cov,cases,chr15,89787120,89787120,0.0,0,205,205
SRR25023303_1_val_1_bismark_bt2_pe.bismark.cov,cases,chr15,89787150,89787150,0.0,0,203,203
SRR25023303_1_val_1_bismark_bt2_pe.bismark.cov,cases,chr15,89787154,89787154,0.492610837438424,1,202,203
SRR25023303_1_val_1_bismark_bt2_pe.bismark.cov,cases,chr15,89787164,89787164,0.0,0,198,198
SRR25023303_1_val_1_bismark_bt2_pe.bismark.cov,cases,chr15,89787168,89787168,0.505050505050505,1,197,198
SRR25023303_1_val_1_bismark_bt2_pe.bismark.cov,cases,chr15,89787171,89787171,0.50761421319797,1,196,197
SRR25023303_1_val_1_bismark_bt2_pe.bismark.cov,cases,chr15,89787182,89787182,0.0,0,193,193
SRR25023303_1_val_1_bismark_bt2_pe.bismark.cov,cases,chr15,89787184,89787184,0.0,0,191,191
SRR25023303_1_val_1_bismark_bt2_pe.bismark.cov,cases,chr15,89787190,89787190,0.540540540540541,1,184,185
SRR25023303_1_val_1_bismark_bt2_pe.bismark.cov,cases,chr15,89787205,89787205,0.0,0,170,170
SRR25023303_1_val_1_bismark_bt2_pe.bismark.cov,cases,chr15,89787212,89787212,0.0,0,127,127
SRR25023303_1_val_1_bismark_bt2_pe.bismark.cov,cases,chr15,89787223,89787223,0.0,0,97,97
SRR25023303_1_val_1_bismark_bt2_pe.bismark.cov,cases,chr15,89787226,89787226,0.0,0,95,95
SRR25023303_1_val_1_bismark_bt2_pe.bismark.cov,cases,chr15,89787238,89787238,0.0,0,111,111
SRR25023303_1_val_1_bismark_bt2_pe.bismark.cov,cases,chr15,89787260,89787260,0.0,0,140,140
SRR25023303_1_val_1_bismark_bt2_pe.bismark.cov,cases,chr15,89787272,89787272,0.0,0,147,147
SRR25023303_1_val_1_bismark_bt2_pe.bismark.cov,cases,chr15,89787288,89787288,0.602409638554217,1,165,166
SRR25023303_1_val_1_bismark_bt2_pe.bismark.cov,cases,chr15,89787293,89787293,0.0,0,176,176
SRR25023303_1_val_1_bismark_bt2_pe.bismark.cov,cases,chr15,89787295,89787295,0.0,0,178,178
SRR25023303_1_val_1_bismark_bt2_pe.bismark.cov,cases,chr15,89787304,89787304,0.540540540540541,1,184,185
SRR25023303_1_val_1_bismark_bt2_pe.bismark.cov,cases,chr15,89787335,89787335,1.03092783505155,2,192,194
SRR25023303_1_val_1_bismark_bt2_pe.bismark.cov,cases,chr8,30890012,30890012,59.4871794871795,348,237,585
SRR25023303_1_val_1_bismark_bt2_pe.bismark.cov,cases,chr8,30890034,30890034,63.9032815198618,370,209,579
SRR25023303_1_val_1_bismark_bt2_pe.bismark.cov,cases,chr8,30890051,30890051,96.1538461538462,550,22,572
SRR25023303_1_val_1_bismark_bt2_pe.bismark.cov,cases,chr8,30890057,30890057,78.6339754816112,449,122,571
SRR25023303_1_val_1_bismark_bt2_pe.bismark.cov,cases,chr8,30890073,30890073,40.8376963350785,234,339,573
SRR25023303_1_val_1_bismark_bt2_pe.bismark.cov,cases,chr8,30890108,30890108,12.1052631578947,69,501,570
SRR25023303_1_val_1_bismark_bt2_pe.bismark.cov,cases,chr8,30890133,30890133,24.6527777777778,142,434,576
SRR25023303_1_val_1_bismark_bt2_pe.bismark.cov,cases,chr8,30890139,30890139,43.4782608695652,250,325,575
SRR25023303_1_val_1_bismark_bt2_pe.bismark.cov,cases,chr8,30890145,30890145,9.58188153310105,55,519,574
SRR25023303_1_val_1_bismark_bt2_pe.bismark.cov,cases,chr8,30890170,30890170,16.2872154115587,93,478,571
SRR25023303_1_val_1_bismark_bt2_pe.bismark.cov,cases,chr8,30890172,30890172,11.0526315789474,63,507,570
SRR25023303_1_val_1_bismark_bt2_pe.bismark.cov,cases,chr8,90997245,90997245,24.8275862068966,36,109,145
SRR25023303_1_val_1_bismark_bt2_pe.bismark.cov,cases,chr8,90997299,90997299,0.0,0,136,136
SRR25023303_1_val_1_bismark_bt2_pe.bismark.cov,cases,chr8,90997454,90997454,21.4285714285714,27,99,126
SRR25023303_1_val_1_bismark_bt2_pe.bismark.cov,cases,chr8,90997482,90997482,95.2755905511811,121,6,127
SRR25023303_1_val_1_bismark_bt2_pe.bismark.cov,cases,chr14,45604787,45604787,0.0,0,364,364
SRR25023303_1_val_1_bismark_bt2_pe.bismark.cov,cases,chr14,45604794,45604794,0.550964187327824,2,361,363
SRR25023303_1_val_1_bismark_bt2_pe.bismark.cov,cases,chr7,6048869,6048869,0.49306625577812,16,3229,3245
SRR25023303_1_val_1_bismark_bt2_pe.bismark.cov,cases,chr7,6048876,6048876,0.338878619839803,11,3235,3246
SRR25023303_1_val_1_bismark_bt2_pe.bismark.cov,cases,chr7,6048884,6048884,0.308832612723904,10,3228,3238
SRR25023303_1_val_1_bismark_bt2_pe.bismark.cov,cases,chr7,6048888,6048888,0.247218788627936,8,3228,3236
SRR25023303_1_val_1_bismark_bt2_pe.bismark.cov,cases,chr7,6048892,6048892,0.401606425702811,13,3224,3237
SRR25023303_1_val_1_bismark_bt2_pe.bismark.cov,cases,chr7,6048904,6048904,0.0,0,620,620
SRR25023303_1_val_1_bismark_bt2_pe.bismark.cov,cases,chr7,6048918,6048918,0.154273372415921,5,3236,3241
SRR25023303_1_val_1_bismark_bt2_pe.bismark.cov,cases,chr7,6048925,6048925,0.215982721382289,7,3234,3241
SRR25023303_1_val_1_bismark_bt2_pe.bismark.cov,cases,chr7,6048928,6048928,0.585516178736518,19,3226,3245
SRR25023303_1_val_1_bismark_bt2_pe.bismark.cov,cases,chr7,6048940,6048940,0.30826140567201,10,3234,3244
SRR25023303_1_val_1_bismark_bt2_pe.bismark.cov,cases,chr7,6048951,6048951,0.154225786551511,5,3237,3242
SRR25023303_1_val_1_bismark_bt2_pe.bismark.cov,cases,chr7,6048966,6048966,0.308356460067838,10,3233,3243
SRR25023303_1_val_1_bismark_bt2_pe.bismark.cov,cases,chr7,6048968,6048968,0.403225806451613,13,3211,3224
SRR25023303_1_val_1_bismark_bt2_pe.bismark.cov,cases,chr17,41277106,41277106,0.899031811894882,13,1433,1446
SRR25023303_1_val_1_bismark_bt2_pe.bismark.cov,cases,chr17,41277115,41277115,0.276052449965493,4,1445,1449
SRR25023303_1_val_1_bismark_bt2_pe.bismark.cov,cases,chr17,41277117,41277117,0.41522491349481,6,1439,1445
SRR25023303_1_val_1_bismark_bt2_pe.bismark.cov,cases,chr17,41277153,41277153,0.414364640883978,6,1442,1448
SRR25023303_1_val_1_bismark_bt2_pe.bismark.cov,cases,chr17,41277160,41277160,0.34435261707989,5,1447,1452
SRR25023303_1_val_1_bismark_bt2_pe.bismark.cov,cases,chr17,41277174,41277174,0.275482093663912,4,1448,1452
SRR25023303_1_val_1_bismark_bt2_pe.bismark.cov,cases,chr17,41277187,41277187,3.29593267882188,47,1379,1426
SRR25023303_1_val_1_bismark_bt2_pe.bismark.cov,cases,chr17,41277214,41277214,0.207182320441989,3,1445,1448
SRR25023303_1_val_1_bismark_bt2_pe.bismark.cov,cases,chr17,41277232,41277232,0.343170899107756,5,1452,1457
SRR25023303_1_val_1_bismark_bt2_pe.bismark.cov,cases,chr17,56769746,56769746,85.4922279792746,165,28,193
SRR25023303_1_val_1_bismark_bt2_pe.bismark.cov,cases,chr17,56769760,56769760,85.7142857142857,168,28,196
SRR25023303_1_val_1_bismark_bt2_pe.bismark.cov,cases,chr17,56769767,56769767,64.7959183673469,127,69,196
SRR25023303_1_val_1_bismark_bt2_pe.bismark.cov,cases,chr17,56769830,56769830,2.63157894736842,5,185,190
SRR25023303_1_val_1_bismark_bt2_pe.bismark.cov,cases,chr17,56769866,56769866,1.57894736842105,3,187,190
SRR25023303_1_val_1_bismark_bt2_pe.bismark.cov,cases,chr17,56769883,56769883,1.05263157894737,2,188,190
SRR25023303_1_val_1_bismark_bt2_pe.bismark.cov,cases,chr17,56769891,56769891,2.10526315789474,4,186,190
SRR25023303_1_val_1_bismark_bt2_pe.bismark.cov,cases,chr17,56769895,56769895,1.05820105820106,2,187,189
SRR25023303_1_val_1_bismark_bt2_pe.bismark.cov,cases,chr17,56769904,56769904,1.06382978723404,2,186,188
SRR25023303_1_val_1_bismark_bt2_pe.bismark.cov,cases,chr17,56769912,56769912,1.05820105820106,2,187,189
SRR25023303_1_val_1_bismark_bt2_pe.bismark.cov,cases,chr17,56769922,56769922,1.05263157894737,2,188,190
SRR25023303_1_val_1_bismark_bt2_pe.bismark.cov,cases,chr17,56769929,56769929,1.05820105820106,2,187,189
SRR25023303_1_val_1_bismark_bt2_pe.bismark.cov,cases,chr17,56769936,56769936,0.0,0,185,185
SRR25023303_1_val_1_bismark_bt2_pe.bismark.cov,cases,chr17,56769941,56769941,0.0,0,185,185
SRR25023303_1_val_1_bismark_bt2_pe.bismark.cov,cases,chr17,56769944,56769944,0.537634408602151,1,185,186
SRR25023303_1_val_1_bismark_bt2_pe.bismark.cov,cases,chr17,56769948,56769948,0.0,0,183,183
SRR25023303_1_val_1_bismark_bt2_pe.bismark.cov,cases,chr17,56769956,56769956,0.0,0,170,170
SRR25023303_1_val_1_bismark_bt2_pe.bismark.cov,cases,chr17,56769962,56769962,0.0,0,161,161
SRR25023303_1_val_1_bismark_bt2_pe.bismark.cov,cases,chr17,56769966,56769966,0.0,0,160,160
SRR25023303_1_val_1_bismark_bt2_pe.bismark.cov,cases,chr17,56769982,56769982,0.0,0,166,166
SRR25023303_1_val_1_bismark_bt2_pe.bismark.cov,cases,chr17,56770003,56770003,0.574712643678161,1,173,174
SRR25023303_1_val_1_bismark_bt2_pe.bismark.cov,cases,chr17,56770008,56770008,0.0,0,176,176
SRR25023303_1_val_1_bismark_bt2_pe.bismark.cov,cases,chr17,56770010,56770010,0.568181818181818,1,175,176
SRR25023303_1_val_1_bismark_bt2_pe.bismark.cov,cases,chr17,56770018,56770018,0.0,0,179,179
SRR25023303_1_val_1_bismark_bt2_pe.bismark.cov,cases,chr17,56770023,56770023,1.11111111111111,2,178,180
SRR25023303_1_val_1_bismark_bt2_pe.bismark.cov,cases,chr17,56770038,56770038,0.0,0,181,181
SRR25023303_1_val_1_bismark_bt2_pe.bismark.cov,cases,chr17,56770057,56770057,2.67379679144385,5,182,187
SRR25023303_1_val_1_bismark_bt2_pe.bismark.cov,cases,chr17,56770069,56770069,0.531914893617021,1,187,188
SRR25023303_1_val_1_bismark_bt2_pe.bismark.cov,cases,chr17,56770074,56770074,0.526315789473684,1,189,190
SRR25023303_1_val_1_bismark_bt2_pe.bismark.cov,cases,chr17,56770093,56770093,0.0,0,191,191
SRR25023303_1_val_1_bismark_bt2_pe.bismark.cov,cases,chr17,59940970,59940970,0.0,0,398,398
SRR25023303_1_val_1_bismark_bt2_pe.bismark.cov,cases,chr17,59940975,59940975,0.0,0,400,400
SRR25023303_1_val_1_bismark_bt2_pe.bismark.cov,cases,chr17,59940988,59940988,0.25062656641604,1,398,399
SRR25023303_1_val_1_bismark_bt2_pe.bismark.cov,cases,chr17,59940997,59940997,0.512820512820513,2,388,390
SRR25023303_1_val_1_bismark_bt2_pe.bismark.cov,cases,chr17,59941017,59941017,0.444444444444444,1,224,225
SRR25023303_1_val_1_bismark_bt2_pe.bismark.cov,cases,chr17,59941051,59941051,0.0,0,398,398
SRR25023303_1_val_1_bismark_bt2_pe.bismark.cov,cases,chr17,59941053,59941053,0.0,0,422,422
SRR25023303_1_val_1_bismark_bt2_pe.bismark.cov,cases,chr17,59941056,59941056,0.251889168765743,1,396,397
SRR25023303_1_val_1_bismark_bt2_pe.bismark.cov,cases,chr17,59941067,59941067,0.0,0,407,407
SRR25023303_1_val_1_bismark_bt2_pe.bismark.cov,cases,chr17,59941110,59941110,0.454545454545455,2,438,440
SRR25023303_1_val_1_bismark_bt2_pe.bismark.cov,cases,chr17,59941133,59941133,0.226757369614512,1,440,441
SRR25023303_1_val_1_bismark_bt2_pe.bismark.cov,cases,chr17,59941136,59941136,0.90702947845805,4,437,441
SRR25023303_1_val_1_bismark_bt2_pe.bismark.cov,cases,chr17,59941187,59941187,0.680272108843537,3,438,441
SRR25023303_1_val_1_bismark_bt2_pe.bismark.cov,cases,chr17,59941191,59941191,0.453514739229025,2,439,441
SRR25023303_1_val_1_bismark_bt2_pe.bismark.cov,cases,chr17,59941201,59941201,0.970873786407767,3,306,309
SRR25023303_1_val_1_bismark_bt2_pe.bismark.cov,cases,chr17,59941202,59941202,0.87719298245614,1,113,114
SRR25023303_1_val_1_bismark_bt2_pe.bismark.cov,cases,chr17,76325846,76325846,45.4545454545455,10,12,22
SRR25023303_1_val_1_bismark_bt2_pe.bismark.cov,cases,chr17,76325851,76325851,9.09090909090909,2,20,22
SRR25023303_1_val_1_bismark_bt2_pe.bismark.cov,cases,chr17,76325865,76325865,13.6363636363636,3,19,22
SRR25023303_1_val_1_bismark_bt2_pe.bismark.cov,cases,chr17,76325979,76325979,63.6363636363636,14,8,22
SRR25023303_1_val_1_bismark_bt2_pe.bismark.cov,cases,chr16,23652769,23652769,0.596125186289121,4,667,671
SRR25023303_1_val_1_bismark_bt2_pe.bismark.cov,cases,chr16,23652783,23652783,0.29673590504451,2,672,674
SRR25023303_1_val_1_bismark_bt2_pe.bismark.cov,cases,chr16,23652787,23652787,0.14903129657228,1,670,671
SRR25023303_1_val_1_bismark_bt2_pe.bismark.cov,cases,chr16,23652797,23652797,0.149476831091181,1,668,669
SRR25023303_1_val_1_bismark_bt2_pe.bismark.cov,cases,chr16,23652818,23652818,0.302114803625378,2,660,662
SRR25023303_1_val_1_bismark_bt2_pe.bismark.cov,cases,chr16,23652838,23652838,0.749625187406297,5,662,667
SRR25023303_1_val_1_bismark_bt2_pe.bismark.cov,cases,chr16,23652857,23652857,0.148588410104012,1,672,673
SRR25023303_1_val_1_bismark_bt2_pe.bismark.cov,cases,chr16,23652860,23652860,0.29585798816568,2,674,676
SRR25023303_1_val_1_bismark_bt2_pe.bismark.cov,cases,chr16,23652876,23652876,0.592592592592593,4,671,675
SRR25023303_1_val_1_bismark_bt2_pe.bismark.cov,cases,chr16,23652906,23652906,0.297176820208024,2,671,673
SRR25023303_1_val_1_bismark_bt2_pe.bismark.cov,cases,chr16,23652911,23652911,0.296296296296296,2,673,675
SRR25023303_1_val_1_bismark_bt2_pe.bismark.cov,cases,chr16,23652916,23652916,0.151515151515152,1,659,660
SRR25023303_1_val_1_bismark_bt2_pe.bismark.cov,cases,chr16,23652918,23652918,0.445103857566766,3,671,674
SRR25023303_1_val_1_bismark_bt2_pe.bismark.cov,cases,chrX,14891454,14891454,26.9201520912547,1416,3844,5260
SRR25023303_1_val_1_bismark_bt2_pe.bismark.cov,cases,chrX,14891470,14891470,24.5390610150162,1291,3970,5261
SRR25023303_1_val_1_bismark_bt2_pe.bismark.cov,cases,chrX,14891474,14891474,24.4545627015747,1289,3982,5271
SRR25023303_1_val_1_bismark_bt2_pe.bismark.cov,cases,chrX,14891488,14891488,21.0775943843673,1111,4160,5271
SRR25023303_1_val_1_bismark_bt2_pe.bismark.cov,cases,chrX,14891493,14891493,44.5182094081942,2347,2925,5272
SRR25023303_1_val_1_bismark_bt2_pe.bismark.cov,cases,chrX,14891496,14891496,34.8625592417062,1839,3436,5275
SRR25023303_1_val_1_bismark_bt2_pe.bismark.cov,cases,chrX,14891499,14891499,23.4010248624027,1233,4036,5269
SRR25023303_1_val_1_bismark_bt2_pe.bismark.cov,cases,chrX,14891509,14891509,38.2716049382716,2015,3250,5265
SRR25023303_1_val_1_bismark_bt2_pe.bismark.cov,cases,chrX,14891516,14891516,37.7727186492127,1991,3280,5271
SRR25023303_1_val_1_bismark_bt2_pe.bismark.cov,cases,chrX,14891524,14891524,26.636311895276,1404,3867,5271
SRR25023303_1_val_1_bismark_bt2_pe.bismark.cov,cases,chrX,14891526,14891526,27.2192716236722,1435,3837,5272
SRR25023303_1_val_1_bismark_bt2_pe.bismark.cov,cases,chrX,14891530,14891530,32.8332700341815,1729,3537,5266
SRR25023303_1_val_1_bismark_bt2_pe.bismark.cov,cases,chr22,29137950,29137950,0.0,0,67,67
SRR25023303_1_val_1_bismark_bt2_pe.bismark.cov,cases,chr22,29137964,29137964,0.0,0,50,50
SRR25023303_1_val_1_bismark_bt2_pe.bismark.cov,cases,chr22,29137975,29137975,0.0,0,33,33
SRR25023303_1_val_1_bismark_bt2_pe.bismark.cov,cases,chr22,29138031,29138031,0.0,0,70,70
SRR25023303_1_val_1_bismark_bt2_pe.bismark.cov,cases,chr22,29138052,29138052,0.0,0,73,73
SRR25023303_1_val_1_bismark_bt2_pe.bismark.cov,cases,chr22,29138062,29138062,0.0,0,75,75
SRR25023303_1_val_1_bismark_bt2_pe.bismark.cov,cases,chr22,29138075,29138075,0.0,0,73,73
SRR25023303_1_val_1_bismark_bt2_pe.bismark.cov,cases,chr22,29138078,29138078,0.0,0,74,74
SRR25023303_1_val_1_bismark_bt2_pe.bismark.cov,cases,chr22,29138091,29138091,0.0,0,69,69
SRR25023303_1_val_1_bismark_bt2_pe.bismark.cov,cases,chr22,29138102,29138102,1.31578947368421,1,75,76
SRR25023303_1_val_1_bismark_bt2_pe.bismark.cov,cases,chr22,29138115,29138115,0.0,0,77,77
SRR25023303_1_val_1_bismark_bt2_pe.bismark.cov,cases,chr22,29138134,29138134,0.0,0,77,77
SRR25023303_1_val_1_bismark_bt2_pe.bismark.cov,cases,chr22,29138158,29138158,0.0,0,80,80
SRR25023303_1_val_1_bismark_bt2_pe.bismark.cov,cases,chr22,29138168,29138168,0.0,0,82,82
SRR25023303_1_val_1_bismark_bt2_pe.bismark.cov,cases,chr22,29138176,29138176,0.0,0,82,82
SRR25023303_1_val_1_bismark_bt2_pe.bismark.cov,cases,chr22,29138179,29138179,0.0,0,84,84
SRR25023303_1_val_1_bismark_bt2_pe.bismark.cov,cases,chr22,29138185,29138185,1.13636363636364,1,87,88
SRR25023303_1_val_1_bismark_bt2_pe.bismark.cov,cases,chr22,29138202,29138202,0.0,0,88,88
SRR25023303_1_val_1_bismark_bt2_pe.bismark.cov,cases,chr22,29138216,29138216,2.24719101123596,2,87,89
SRR25023303_1_val_1_bismark_bt2_pe.bismark.cov,cases,chr22,29138219,29138219,0.0,0,89,89
SRR25023303_1_val_1_bismark_bt2_pe.bismark.cov,cases,chr22,29138234,29138234,0.0,0,89,89
SRR25023303_1_val_1_bismark_bt2_pe.bismark.cov,cases,chr22,29138238,29138238,0.0,0,89,89
SRR25023304_1_val_1_bismark_bt2_pe.bismark.cov,cases,chr10,89619506,89619506,97.7713178294574,1009,23,1032
SRR25023304_1_val_1_bismark_bt2_pe.bismark.cov,cases,chr10,89619510,89619510,98.3543078412391,1016,17,1033
SRR25023304_1_val_1_bismark_bt2_pe.bismark.cov,cases,chr10,89619512,89619512,98.743961352657,1022,13,1035
SRR25023304_1_val_1_bismark_bt2_pe.bismark.cov,cases,chr10,89619522,89619522,98.6538461538462,1026,14,1040
SRR25023304_1_val_1_bismark_bt2_pe.bismark.cov,cases,chr10,89619550,89619550,98.1730769230769,1021,19,1040
SRR25023304_1_val_1_bismark_bt2_pe.bismark.cov,cases,chr10,89619555,89619555,97.4038461538461,1013,27,1040
SRR25023304_1_val_1_bismark_bt2_pe.bismark.cov,cases,chr10,89619566,89619566,95.3801732435034,991,48,1039
SRR25023304_1_val_1_bismark_bt2_pe.bismark.cov,cases,chr10,89619580,89619580,91.5057915057915,948,88,1036
SRR25023304_1_val_1_bismark_bt2_pe.bismark.cov,cases,chr3,37034307,37034307,99.9261992619926,2708,2,2710
SRR25023304_1_val_1_bismark_bt2_pe.bismark.cov,cases,chr3,37034316,37034316,0.257637099742363,7,2710,2717
SRR25023304_1_val_1_bismark_bt2_pe.bismark.cov,cases,chr3,37034324,37034324,0.220994475138122,6,2709,2715
SRR25023304_1_val_1_bismark_bt2_pe.bismark.cov,cases,chr3,37034330,37034330,0.257542310522443,7,2711,2718
SRR25023304_1_val_1_bismark_bt2_pe.bismark.cov,cases,chr3,37034344,37034344,0.404560500183891,11,2708,2719
SRR25023304_1_val_1_bismark_bt2_pe.bismark.cov,cases,chr3,37034346,37034346,0.478645066273932,13,2703,2716
SRR25023304_1_val_1_bismark_bt2_pe.bismark.cov,cases,chr3,37034348,37034348,0.478468899521531,13,2704,2717
SRR25023304_1_val_1_bismark_bt2_pe.bismark.cov,cases,chr3,37034352,37034352,0.625,17,2703,2720
SRR25023304_1_val_1_bismark_bt2_pe.bismark.cov,cases,chr3,37034355,37034355,0.845588235294118,23,2697,2720
SRR25023304_1_val_1_bismark_bt2_pe.bismark.cov,cases,chr3,37034359,37034359,0.514705882352941,14,2706,2720
SRR25023304_1_val_1_bismark_bt2_pe.bismark.cov,cases,chr3,37034369,37034369,0.641993957703928,17,2631,2648
SRR25023304_1_val_1_bismark_bt2_pe.bismark.cov,cases,chr3,37034373,37034373,0.551267916207277,15,2706,2721
SRR25023304_1_val_1_bismark_bt2_pe.bismark.cov,cases,chr3,37034382,37034382,0.441014332965821,12,2709,2721
SRR25023304_1_val_1_bismark_bt2_pe.bismark.cov,cases,chr3,37034394,37034394,0.441014332965821,12,2709,2721
SRR25023304_1_val_1_bismark_bt2_pe.bismark.cov,cases,chr3,37034402,37034402,0.514516721793458,14,2707,2721
SRR25023304_1_val_1_bismark_bt2_pe.bismark.cov,cases,chr3,37034409,37034409,0.183621006243114,5,2718,2723
SRR25023304_1_val_1_bismark_bt2_pe.bismark.cov,cases,chr3,37034412,37034412,0.220426157237326,6,2716,2722
SRR25023304_1_val_1_bismark_bt2_pe.bismark.cov,cases,chr3,37034414,37034414,0.330882352941176,9,2711,2720
SRR25023304_1_val_1_bismark_bt2_pe.bismark.cov,cases,chr3,37034418,37034418,0.514516721793458,14,2707,2721
SRR25023304_1_val_1_bismark_bt2_pe.bismark.cov,cases,chr3,37034420,37034420,0.257447591026113,7,2712,2719
SRR25023304_1_val_1_bismark_bt2_pe.bismark.cov,cases,chr3,37034430,37034430,0.147275405007364,4,2712,2716
SRR25023304_1_val_1_bismark_bt2_pe.bismark.cov,cases,chr3,37034438,37034438,0.55207949944792,15,2702,2717
SRR25023304_1_val_1_bismark_bt2_pe.bismark.cov,cases,chr3,37034441,37034441,0.294767870302137,8,2706,2714
SRR25023304_1_val_1_bismark_bt2_pe.bismark.cov,cases,chr3,37034466,37034466,100.0,2710,0,2710
SRR25023304_1_val_1_bismark_bt2_pe.bismark.cov,cases,chr3,37034997,37034997,0.397515527950311,16,4009,4025
SRR25023304_1_val_1_bismark_bt2_pe.bismark.cov,cases,chr3,37035012,37035012,0.297766749379653,12,4018,4030
SRR25023304_1_val_1_bismark_bt2_pe.bismark.cov,cases,chr3,37035032,37035032,0.471698113207547,19,4009,4028
SRR25023304_1_val_1_bismark_bt2_pe.bismark.cov,cases,chr3,37035043,37035043,0.744601638123604,30,3999,4029
SRR25023304_1_val_1_bismark_bt2_pe.bismark.cov,cases,chr3,37035047,37035047,0.198412698412698,8,4024,4032
SRR25023304_1_val_1_bismark_bt2_pe.bismark.cov,cases,chr3,37035063,37035063,0.668482297598415,27,4012,4039
SRR25023304_1_val_1_bismark_bt2_pe.bismark.cov,cases,chr3,37035066,37035066,0.717821782178218,29,4011,4040
SRR25023304_1_val_1_bismark_bt2_pe.bismark.cov,cases,chr3,37035074,37035074,0.346878097125867,14,4022,4036
SRR25023304_1_val_1_bismark_bt2_pe.bismark.cov,cases,chr3,37035090,37035090,0.321782178217822,13,4027,4040
SRR25023304_1_val_1_bismark_bt2_pe.bismark.cov,cases,chr3,37035095,37035095,0.569729997522913,23,4014,4037
SRR25023304_1_val_1_bismark_bt2_pe.bismark.cov,cases,chr3,37035097,37035097,0.495049504950495,20,4020,4040
SRR25023304_1_val_1_bismark_bt2_pe.bismark.cov,cases,chr3,37035100,37035100,0.446096654275093,18,4017,4035
SRR25023304_1_val_1_bismark_bt2_pe.bismark.cov,cases,chr3,37035117,37035117,0.321782178217822,13,4027,4040
SRR25023304_1_val_1_bismark_bt2_pe.bismark.cov,cases,chr3,142297977,142297977,0.731895223420647,19,2577,2596
SRR25023304_1_val_1_bismark_bt2_pe.bismark.cov,cases,chr3,142298019,142298019,0.846805234795997,22,2576,2598
SRR25023304_1_val_1_bismark_bt2_pe.bismark.cov,cases,chr3,142298045,142298045,0.42421905129194,11,2582,2593
SRR25023304_1_val_1_bismark_bt2_pe.bismark.cov,cases,chr3,142298054,142298054,2.78637770897833,72,2512,2584
SRR25023304_1_val_1_bismark_bt2_pe.bismark.cov,cases,chr13,32889392,32889392,12.9623873173764,417,2800,3217
SRR25023304_1_val_1_bismark_bt2_pe.bismark.cov,cases,chr13,32889434,32889434,1.96567862714509,63,3142,3205
SRR25023304_1_val_1_bismark_bt2_pe.bismark.cov,cases,chr13,32889461,32889461,0.562675836198812,18,3181,3199
SRR25023304_1_val_1_bismark_bt2_pe.bismark.cov,cases,chr13,32889470,32889470,0.156201187129022,5,3196,3201
SRR25023304_1_val_1_bismark_bt2_pe.bismark.cov,cases,chr13,32889484,32889484,0.249687890137328,8,3196,3204
SRR25023304_1_val_1_bismark_bt2_pe.bismark.cov,cases,chr13,108867034,108867034,41.0703897614892,706,1013,1719
SRR25023304_1_val_1_bismark_bt2_pe.bismark.cov,cases,chr13,108867035,108867035,0.0,0,21,21
SRR25023304_1_val_1_bismark_bt2_pe.bismark.cov,cases,chr13,108867044,108867044,46.4490263459336,811,935,1746
SRR25023304_1_val_1_bismark_bt2_pe.bismark.cov,cases,chr13,108867051,108867051,49.7133027522936,867,877,1744
SRR25023304_1_val_1_bismark_bt2_pe.bismark.cov,cases,chr13,108867109,108867109,74.7722095671982,1313,443,1756
SRR25023304_1_val_1_bismark_bt2_pe.bismark.cov,cases,chr13,108867112,108867112,84.0637450199203,1477,280,1757
SRR25023304_1_val_1_bismark_bt2_pe.bismark.cov,cases,chr13,108867124,108867124,62.2006841505131,1091,663,1754
SRR25023304_1_val_1_bismark_bt2_pe.bismark.cov,cases,chr13,108867135,108867135,52.8538812785388,926,826,1752
SRR25023304_1_val_1_bismark_bt2_pe.bismark.cov,cases,chr13,108867155,108867155,45.5688965122927,797,952,1749
SRR25023304_1_val_1_bismark_bt2_pe.bismark.cov,cases,chr2,47596828,47596828,3.23809523809524,34,1016,1050
SRR25023304_1_val_1_bismark_bt2_pe.bismark.cov,cases,chr2,47596830,47596830,1.40449438202247,15,1053,1068
SRR25023304_1_val_1_bismark_bt2_pe.bismark.cov,cases,chr2,47596840,47596840,3.72786579683131,40,1033,1073
SRR25023304_1_val_1_bismark_bt2_pe.bismark.cov,cases,chr2,47596849,47596849,12.5815470643057,135,938,1073
SRR25023304_1_val_1_bismark_bt2_pe.bismark.cov,cases,chr2,47596853,47596853,2.52100840336134,27,1044,1071
SRR25023304_1_val_1_bismark_bt2_pe.bismark.cov,cases,chr2,47596858,47596858,5.8659217877095,63,1011,1074
SRR25023304_1_val_1_bismark_bt2_pe.bismark.cov,cases,chr2,47596862,47596862,6.70391061452514,72,1002,1074
SRR25023304_1_val_1_bismark_bt2_pe.bismark.cov,cases,chr2,47596869,47596869,15.828677839851,170,904,1074
SRR25023304_1_val_1_bismark_bt2_pe.bismark.cov,cases,chr2,47596883,47596883,9.45692883895131,101,967,1068
SRR25023304_1_val_1_bismark_bt2_pe.bismark.cov,cases,chr2,47596885,47596885,1.68224299065421,18,1052,1070
SRR25023304_1_val_1_bismark_bt2_pe.bismark.cov,cases,chr2,47596887,47596887,4.66853408029879,50,1021,1071
SRR25023304_1_val_1_bismark_bt2_pe.bismark.cov,cases,chr2,47596897,47596897,2.79850746268657,30,1042,1072
SRR25023304_1_val_1_bismark_bt2_pe.bismark.cov,cases,chr2,47596900,47596900,2.33426704014939,25,1046,1071
SRR25023304_1_val_1_bismark_bt2_pe.bismark.cov,cases,chr2,47596907,47596907,1.87793427230047,20,1045,1065
SRR25023304_1_val_1_bismark_bt2_pe.bismark.cov,cases,chr2,47596912,47596912,1.03383458646617,11,1053,1064
SRR25023304_1_val_1_bismark_bt2_pe.bismark.cov,cases,chr2,47596930,47596930,3.28638497652582,35,1030,1065
SRR25023304_1_val_1_bismark_bt2_pe.bismark.cov,cases,chr2,47596942,47596942,2.8116213683224,30,1037,1067
SRR25023304_1_val_1_bismark_bt2_pe.bismark.cov,cases,chr2,47630224,47630224,0.974025974025974,9,915,924
SRR25023304_1_val_1_bismark_bt2_pe.bismark.cov,cases,chr2,47630227,47630227,1.58730158730159,15,930,945
SRR25023304_1_val_1_bismark_bt2_pe.bismark.cov,cases,chr2,47630233,47630233,0.316789862724393,3,944,947
SRR25023304_1_val_1_bismark_bt2_pe.bismark.cov,cases,chr2,47630237,47630237,0.105708245243129,1,945,946
SRR25023304_1_val_1_bismark_bt2_pe.bismark.cov,cases,chr2,47630240,47630240,0.529661016949152,5,939,944
SRR25023304_1_val_1_bismark_bt2_pe.bismark.cov,cases,chr2,47630244,47630244,1.3771186440678,13,931,944
SRR25023304_1_val_1_bismark_bt2_pe.bismark.cov,cases,chr2,47630251,47630251,0.739957716701903,7,939,946
SRR25023304_1_val_1_bismark_bt2_pe.bismark.cov,cases,chr2,47630265,47630265,0.0,0,943,943
SRR25023304_1_val_1_bismark_bt2_pe.bismark.cov,cases,chr2,47630292,47630292,0.423728813559322,4,940,944
SRR25023304_1_val_1_bismark_bt2_pe.bismark.cov,cases,chr2,47630294,47630294,0.422832980972516,4,942,946
SRR25023304_1_val_1_bismark_bt2_pe.bismark.cov,cases,chr2,128051674,128051674,0.0,0,222,222
SRR25023304_1_val_1_bismark_bt2_pe.bismark.cov,cases,chr2,128051690,128051690,0.235294117647059,2,848,850
SRR25023304_1_val_1_bismark_bt2_pe.bismark.cov,cases,chr2,128051704,128051704,0.586854460093897,5,847,852
SRR25023304_1_val_1_bismark_bt2_pe.bismark.cov,cases,chr2,128051707,128051707,0.116959064327485,1,854,855
SRR25023304_1_val_1_bismark_bt2_pe.bismark.cov,cases,chr2,128051709,128051709,0.819672131147541,7,847,854
SRR25023304_1_val_1_bismark_bt2_pe.bismark.cov,cases,chr2,128051716,128051716,0.82256169212691,7,844,851
SRR25023304_1_val_1_bismark_bt2_pe.bismark.cov,cases,chr2,128051733,128051733,0.117370892018779,1,851,852
SRR25023304_1_val_1_bismark_bt2_pe.bismark.cov,cases,chr2,128051743,128051743,0.705882352941177,6,844,850
SRR25023304_1_val_1_bismark_bt2_pe.bismark.cov,cases,chr2,178787742,178787742,94.6257197696737,493,28,521
SRR25023304_1_val_1_bismark_bt2_pe.bismark.cov,cases,chr2,241151145,241151145,96.1538461538462,25,1,26
SRR25023304_1_val_1_bismark_bt2_pe.bismark.cov,cases,chr2,241151165,241151165,85.7142857142857,24,4,28
SRR25023304_1_val_1_bismark_bt2_pe.bismark.cov,cases,chr2,241151205,241151205,100.0,30,0,30
SRR25023304_1_val_1_bismark_bt2_pe.bismark.cov,cases,chr2,241151217,241151217,96.551724137931,28,1,29
SRR25023304_1_val_1_bismark_bt2_pe.bismark.cov,cases,chr2,241151277,241151277,0.0,0,23,23
SRR25023304_1_val_1_bismark_bt2_pe.bismark.cov,cases,chr8,30890012,30890012,62.5187406296852,417,250,667
SRR25023304_1_val_1_bismark_bt2_pe.bismark.cov,cases,chr8,30890034,30890034,63.5670731707317,417,239,656
SRR25023304_1_val_1_bismark_bt2_pe.bismark.cov,cases,chr8,30890051,30890051,95.2453987730061,621,31,652
SRR25023304_1_val_1_bismark_bt2_pe.bismark.cov,cases,chr8,30890057,30890057,78.680981595092,513,139,652
SRR25023304_1_val_1_bismark_bt2_pe.bismark.cov,cases,chr8,30890073,30890073,46.5437788018433,303,348,651
SRR25023304_1_val_1_bismark_bt2_pe.bismark.cov,cases,chr8,30890108,30890108,12.7158555729984,81,556,637
SRR25023304_1_val_1_bismark_bt2_pe.bismark.cov,cases,chr8,30890133,30890133,22.2047244094488,141,494,635
SRR25023304_1_val_1_bismark_bt2_pe.bismark.cov,cases,chr8,30890139,30890139,45.5259026687598,290,347,637
SRR25023304_1_val_1_bismark_bt2_pe.bismark.cov,cases,chr8,30890145,30890145,6.89655172413793,44,594,638
SRR25023304_1_val_1_bismark_bt2_pe.bismark.cov,cases,chr8,30890170,30890170,18.8976377952756,120,515,635
SRR25023304_1_val_1_bismark_bt2_pe.bismark.cov,cases,chr8,30890172,30890172,13.968253968254,88,542,630
SRR25023304_1_val_1_bismark_bt2_pe.bismark.cov,cases,chr8,90997245,90997245,22.2222222222222,16,56,72
SRR25023304_1_val_1_bismark_bt2_pe.bismark.cov,cases,chr8,90997299,90997299,1.42857142857143,1,69,70
SRR25023304_1_val_1_bismark_bt2_pe.bismark.cov,cases,chr8,90997454,90997454,31.25,20,44,64
SRR25023304_1_val_1_bismark_bt2_pe.bismark.cov,cases,chr8,90997482,90997482,100.0,63,0,63
SRR25023304_1_val_1_bismark_bt2_pe.bismark.cov,cases,chr15,89786999,89786999,3.125,4,124,128
SRR25023304_1_val_1_bismark_bt2_pe.bismark.cov,cases,chr15,89787007,89787007,0.0,0,133,133
SRR25023304_1_val_1_bismark_bt2_pe.bismark.cov,cases,chr15,89787009,89787009,0.757575757575758,1,131,132
SRR25023304_1_val_1_bismark_bt2_pe.bismark.cov,cases,chr15,89787018,89787018,0.0,0,133,133
SRR25023304_1_val_1_bismark_bt2_pe.bismark.cov,cases,chr15,89787032,89787032,2.29007633587786,3,128,131
SRR25023304_1_val_1_bismark_bt2_pe.bismark.cov,cases,chr15,89787034,89787034,0.0,0,131,131
SRR25023304_1_val_1_bismark_bt2_pe.bismark.cov,cases,chr15,89787036,89787036,0.0,0,131,131
SRR25023304_1_val_1_bismark_bt2_pe.bismark.cov,cases,chr15,89787045,89787045,0.0,0,130,130
SRR25023304_1_val_1_bismark_bt2_pe.bismark.cov,cases,chr15,89787048,89787048,0.0,0,131,131
SRR25023304_1_val_1_bismark_bt2_pe.bismark.cov,cases,chr15,89787058,89787058,0.769230769230769,1,129,130
SRR25023304_1_val_1_bismark_bt2_pe.bismark.cov,cases,chr15,89787060,89787060,0.769230769230769,1,129,130
SRR25023304_1_val_1_bismark_bt2_pe.bismark.cov,cases,chr15,89787066,89787066,0.769230769230769,1,129,130
SRR25023304_1_val_1_bismark_bt2_pe.bismark.cov,cases,chr15,89787077,89787077,0.0,0,130,130
SRR25023304_1_val_1_bismark_bt2_pe.bismark.cov,cases,chr15,89787087,89787087,3.125,4,124,128
SRR25023304_1_val_1_bismark_bt2_pe.bismark.cov,cases,chr15,89787103,89787103,0.0,0,127,127
SRR25023304_1_val_1_bismark_bt2_pe.bismark.cov,cases,chr15,89787109,89787109,0.78740157480315,1,126,127
SRR25023304_1_val_1_bismark_bt2_pe.bismark.cov,cases,chr15,89787113,89787113,0.793650793650794,1,125,126
SRR25023304_1_val_1_bismark_bt2_pe.bismark.cov,cases,chr15,89787120,89787120,0.0,0,126,126
SRR25023304_1_val_1_bismark_bt2_pe.bismark.cov,cases,chr15,89787150,89787150,0.806451612903226,1,123,124
SRR25023304_1_val_1_bismark_bt2_pe.bismark.cov,cases,chr15,89787154,89787154,0.0,0,124,124
SRR25023304_1_val_1_bismark_bt2_pe.bismark.cov,cases,chr15,89787164,89787164,1.63934426229508,2,120,122
SRR25023304_1_val_1_bismark_bt2_pe.bismark.cov,cases,chr15,89787168,89787168,0.0,0,118,118
SRR25023304_1_val_1_bismark_bt2_pe.bismark.cov,cases,chr15,89787171,89787171,0.0,0,118,118
SRR25023304_1_val_1_bismark_bt2_pe.bismark.cov,cases,chr15,89787182,89787182,0.862068965517241,1,115,116
SRR25023304_1_val_1_bismark_bt2_pe.bismark.cov,cases,chr15,89787184,89787184,0.0,0,116,116
SRR25023304_1_val_1_bismark_bt2_pe.bismark.cov,cases,chr15,89787190,89787190,0.0,0,114,114
SRR25023304_1_val_1_bismark_bt2_pe.bismark.cov,cases,chr15,89787205,89787205,0.0,0,110,110
SRR25023304_1_val_1_bismark_bt2_pe.bismark.cov,cases,chr15,89787212,89787212,0.0,0,94,94
SRR25023304_1_val_1_bismark_bt2_pe.bismark.cov,cases,chr15,89787223,89787223,0.0,0,72,72
SRR25023304_1_val_1_bismark_bt2_pe.bismark.cov,cases,chr15,89787226,89787226,0.0,0,70,70
SRR25023304_1_val_1_bismark_bt2_pe.bismark.cov,cases,chr15,89787238,89787238,0.0,0,78,78
SRR25023304_1_val_1_bismark_bt2_pe.bismark.cov,cases,chr15,89787260,89787260,1.13636363636364,1,87,88
SRR25023304_1_val_1_bismark_bt2_pe.bismark.cov,cases,chr15,89787272,89787272,1.0752688172043,1,92,93
SRR25023304_1_val_1_bismark_bt2_pe.bismark.cov,cases,chr15,89787288,89787288,2.77777777777778,3,105,108
SRR25023304_1_val_1_bismark_bt2_pe.bismark.cov,cases,chr15,89787293,89787293,0.0,0,112,112
SRR25023304_1_val_1_bismark_bt2_pe.bismark.cov,cases,chr15,89787295,89787295,0.884955752212389,1,112,113
SRR25023304_1_val_1_bismark_bt2_pe.bismark.cov,cases,chr15,89787304,89787304,0.0,0,116,116
SRR25023304_1_val_1_bismark_bt2_pe.bismark.cov,cases,chr15,89787335,89787335,0.793650793650794,1,125,126
SRR25023304_1_val_1_bismark_bt2_pe.bismark.cov,cases,chr11,108093323,108093323,1.06888361045131,9,833,842
SRR25023304_1_val_1_bismark_bt2_pe.bismark.cov,cases,chr11,108093335,108093335,0.118343195266272,1,844,845
SRR25023304_1_val_1_bismark_bt2_pe.bismark.cov,cases,chr11,108093338,108093338,0.355029585798817,3,842,845
SRR25023304_1_val_1_bismark_bt2_pe.bismark.cov,cases,chr11,108093359,108093359,0.599520383693046,5,829,834
SRR25023304_1_val_1_bismark_bt2_pe.bismark.cov,cases,chr11,108093371,108093371,1.94319880418535,13,656,669
SRR25023304_1_val_1_bismark_bt2_pe.bismark.cov,cases,chr11,108093373,108093373,0.298953662182362,2,667,669
SRR25023304_1_val_1_bismark_bt2_pe.bismark.cov,cases,chr11,108093386,108093386,0.148809523809524,1,671,672
SRR25023304_1_val_1_bismark_bt2_pe.bismark.cov,cases,chr11,108093395,108093395,0.446428571428571,3,669,672
SRR25023304_1_val_1_bismark_bt2_pe.bismark.cov,cases,chr11,108093402,108093402,1.05105105105105,7,659,666
SRR25023304_1_val_1_bismark_bt2_pe.bismark.cov,cases,chr11,108093413,108093413,0.451807228915663,3,661,664
SRR25023304_1_val_1_bismark_bt2_pe.bismark.cov,cases,chr11,108093419,108093419,0.602409638554217,4,660,664
SRR25023304_1_val_1_bismark_bt2_pe.bismark.cov,cases,chr11,108093436,108093436,0.151515151515152,1,659,660
SRR25023304_1_val_1_bismark_bt2_pe.bismark.cov,cases,chr11,108093439,108093439,0.757575757575758,5,655,660
SRR25023304_1_val_1_bismark_bt2_pe.bismark.cov,cases,chr11,108093451,108093451,0.303030303030303,2,658,660
SRR25023304_1_val_1_bismark_bt2_pe.bismark.cov,cases,chr11,108093457,108093457,0.606980273141123,4,655,659
SRR25023304_1_val_1_bismark_bt2_pe.bismark.cov,cases,chr11,108093461,108093461,0.0,0,660,660
SRR25023304_1_val_1_bismark_bt2_pe.bismark.cov,cases,chr11,108093467,108093467,0.909090909090909,6,654,660
SRR25023304_1_val_1_bismark_bt2_pe.bismark.cov,cases,chr11,108093476,108093476,0.758725341426404,5,654,659
SRR25023304_1_val_1_bismark_bt2_pe.bismark.cov,cases,chr11,108093485,108093485,0.153374233128834,1,651,652
SRR25023304_1_val_1_bismark_bt2_pe.bismark.cov,cases,chr11,108093505,108093505,1.81518151815182,11,595,606
SRR25023304_1_val_1_bismark_bt2_pe.bismark.cov,cases,chr11,108093520,108093520,0.0,0,506,506
SRR25023304_1_val_1_bismark_bt2_pe.bismark.cov,cases,chr11,108093529,108093529,0.0,0,91,91
SRR25023304_1_val_1_bismark_bt2_pe.bismark.cov,cases,chr11,108093532,108093532,0.0,0,111,111
SRR25023304_1_val_1_bismark_bt2_pe.bismark.cov,cases,chr11,108093538,108093538,0.0,0,139,139
SRR25023304_1_val_1_bismark_bt2_pe.bismark.cov,cases,chr11,108093560,108093560,0.545454545454546,3,547,550
SRR25023304_1_val_1_bismark_bt2_pe.bismark.cov,cases,chr11,108093567,108093567,0.345423143350604,2,577,579
SRR25023304_1_val_1_bismark_bt2_pe.bismark.cov,cases,chr11,108093572,108093572,0.505902192242833,3,590,593
SRR25023304_1_val_1_bismark_bt2_pe.bismark.cov,cases,chr11,108093579,108093579,0.661157024793388,4,601,605
SRR25023304_1_val_1_bismark_bt2_pe.bismark.cov,cases,chr11,108093584,108093584,0.0,0,626,626
SRR25023304_1_val_1_bismark_bt2_pe.bismark.cov,cases,chr11,108093590,108093590,0.153846153846154,1,649,650
SRR25023304_1_val_1_bismark_bt2_pe.bismark.cov,cases,chr11,108093598,108093598,0.151975683890578,1,657,658
SRR25023304_1_val_1_bismark_bt2_pe.bismark.cov,cases,chr17,13571583,13571583,90.4761904761905,19,2,21
SRR25023304_1_val_1_bismark_bt2_pe.bismark.cov,cases,chr17,13571613,13571613,90.4761904761905,19,2,21
SRR25023304_1_val_1_bismark_bt2_pe.bismark.cov,cases,chr17,41277106,41277106,0.525624178712221,8,1514,1522
SRR25023304_1_val_1_bismark_bt2_pe.bismark.cov,cases,chr17,41277115,41277115,0.26281208935611,4,1518,1522
SRR25023304_1_val_1_bismark_bt2_pe.bismark.cov,cases,chr17,41277117,41277117,1.11695137976347,17,1505,1522
SRR25023304_1_val_1_bismark_bt2_pe.bismark.cov,cases,chr17,41277153,41277153,0.595632031767042,9,1502,1511
SRR25023304_1_val_1_bismark_bt2_pe.bismark.cov,cases,chr17,41277160,41277160,0.528750826173166,8,1505,1513
SRR25023304_1_val_1_bismark_bt2_pe.bismark.cov,cases,chr17,41277174,41277174,0.593276203032301,9,1508,1517
SRR25023304_1_val_1_bismark_bt2_pe.bismark.cov,cases,chr17,41277214,41277214,0.655307994757536,10,1516,1526
SRR25023304_1_val_1_bismark_bt2_pe.bismark.cov,cases,chr17,41277232,41277232,1.18032786885246,18,1507,1525
SRR25023304_1_val_1_bismark_bt2_pe.bismark.cov,cases,chr17,56769746,56769746,96.2406015037594,128,5,133
SRR25023304_1_val_1_bismark_bt2_pe.bismark.cov,cases,chr17,56769760,56769760,92.5373134328358,124,10,134
SRR25023304_1_val_1_bismark_bt2_pe.bismark.cov,cases,chr17,56769767,56769767,82.8358208955224,111,23,134
SRR25023304_1_val_1_bismark_bt2_pe.bismark.cov,cases,chr17,56769830,56769830,3.64963503649635,5,132,137
SRR25023304_1_val_1_bismark_bt2_pe.bismark.cov,cases,chr17,56769866,56769866,0.0,0,138,138
SRR25023304_1_val_1_bismark_bt2_pe.bismark.cov,cases,chr17,56769883,56769883,0.72992700729927,1,136,137
SRR25023304_1_val_1_bismark_bt2_pe.bismark.cov,cases,chr17,56769891,56769891,0.0,0,136,136
SRR25023304_1_val_1_bismark_bt2_pe.bismark.cov,cases,chr17,56769895,56769895,2.94117647058824,4,132,136
SRR25023304_1_val_1_bismark_bt2_pe.bismark.cov,cases,chr17,56769904,56769904,0.735294117647059,1,135,136
SRR25023304_1_val_1_bismark_bt2_pe.bismark.cov,cases,chr17,56769912,56769912,0.0,0,135,135
SRR25023304_1_val_1_bismark_bt2_pe.bismark.cov,cases,chr17,56769922,56769922,0.0,0,133,133
SRR25023304_1_val_1_bismark_bt2_pe.bismark.cov,cases,chr17,56769929,56769929,3.00751879699248,4,129,133
SRR25023304_1_val_1_bismark_bt2_pe.bismark.cov,cases,chr17,56769936,56769936,0.0,0,134,134
SRR25023304_1_val_1_bismark_bt2_pe.bismark.cov,cases,chr17,56769941,56769941,0.0,0,134,134
SRR25023304_1_val_1_bismark_bt2_pe.bismark.cov,cases,chr17,56769944,56769944,5.26315789473684,7,126,133
SRR25023304_1_val_1_bismark_bt2_pe.bismark.cov,cases,chr17,56769948,56769948,0.0,0,133,133
SRR25023304_1_val_1_bismark_bt2_pe.bismark.cov,cases,chr17,56769956,56769956,1.61290322580645,2,122,124
SRR25023304_1_val_1_bismark_bt2_pe.bismark.cov,cases,chr17,56769962,56769962,0.909090909090909,1,109,110
SRR25023304_1_val_1_bismark_bt2_pe.bismark.cov,cases,chr17,56769966,56769966,0.0,0,112,112
SRR25023304_1_val_1_bismark_bt2_pe.bismark.cov,cases,chr17,56769982,56769982,0.0,0,114,114
SRR25023304_1_val_1_bismark_bt2_pe.bismark.cov,cases,chr17,56770003,56770003,3.30578512396694,4,117,121
SRR25023304_1_val_1_bismark_bt2_pe.bismark.cov,cases,chr17,56770008,56770008,0.0,0,119,119
SRR25023304_1_val_1_bismark_bt2_pe.bismark.cov,cases,chr17,56770010,56770010,0.0,0,120,120
SRR25023304_1_val_1_bismark_bt2_pe.bismark.cov,cases,chr17,56770018,56770018,0.0,0,123,123
SRR25023304_1_val_1_bismark_bt2_pe.bismark.cov,cases,chr17,56770023,56770023,5.64516129032258,7,117,124
SRR25023304_1_val_1_bismark_bt2_pe.bismark.cov,cases,chr17,56770038,56770038,0.0,0,124,124
SRR25023304_1_val_1_bismark_bt2_pe.bismark.cov,cases,chr17,56770057,56770057,0.793650793650794,1,125,126
SRR25023304_1_val_1_bismark_bt2_pe.bismark.cov,cases,chr17,56770069,56770069,0.0,0,127,127
SRR25023304_1_val_1_bismark_bt2_pe.bismark.cov,cases,chr17,56770074,56770074,0.0,0,128,128
SRR25023304_1_val_1_bismark_bt2_pe.bismark.cov,cases,chr17,56770093,56770093,0.0,0,128,128
SRR25023304_1_val_1_bismark_bt2_pe.bismark.cov,cases,chr17,59940970,59940970,1.88679245283019,3,156,159
SRR25023304_1_val_1_bismark_bt2_pe.bismark.cov,cases,chr17,59940975,59940975,0.0,0,159,159
SRR25023304_1_val_1_bismark_bt2_pe.bismark.cov,cases,chr17,59940988,59940988,1.25786163522013,2,157,159
SRR25023304_1_val_1_bismark_bt2_pe.bismark.cov,cases,chr17,59940997,59940997,0.0,0,155,155
SRR25023304_1_val_1_bismark_bt2_pe.bismark.cov,cases,chr17,59941017,59941017,1.08695652173913,1,91,92
SRR25023304_1_val_1_bismark_bt2_pe.bismark.cov,cases,chr17,59941051,59941051,0.0,0,161,161
SRR25023304_1_val_1_bismark_bt2_pe.bismark.cov,cases,chr17,59941053,59941053,0.0,0,175,175
SRR25023304_1_val_1_bismark_bt2_pe.bismark.cov,cases,chr17,59941056,59941056,1.24223602484472,2,159,161
SRR25023304_1_val_1_bismark_bt2_pe.bismark.cov,cases,chr17,59941067,59941067,1.78571428571429,3,165,168
SRR25023304_1_val_1_bismark_bt2_pe.bismark.cov,cases,chr17,59941110,59941110,0.0,0,183,183
SRR25023304_1_val_1_bismark_bt2_pe.bismark.cov,cases,chr17,59941133,59941133,0.0,0,183,183
SRR25023304_1_val_1_bismark_bt2_pe.bismark.cov,cases,chr17,59941136,59941136,0.546448087431694,1,182,183
SRR25023304_1_val_1_bismark_bt2_pe.bismark.cov,cases,chr17,59941187,59941187,0.0,0,183,183
SRR25023304_1_val_1_bismark_bt2_pe.bismark.cov,cases,chr17,59941191,59941191,1.09289617486339,2,181,183
SRR25023304_1_val_1_bismark_bt2_pe.bismark.cov,cases,chr17,59941201,59941201,1.41843971631206,2,139,141
SRR25023304_1_val_1_bismark_bt2_pe.bismark.cov,cases,chr17,59941202,59941202,2.77777777777778,1,35,36
SRR25023304_1_val_1_bismark_bt2_pe.bismark.cov,cases,chr17,76325846,76325846,33.8235294117647,23,45,68
SRR25023304_1_val_1_bismark_bt2_pe.bismark.cov,cases,chr17,76325851,76325851,13.2352941176471,9,59,68
SRR25023304_1_val_1_bismark_bt2_pe.bismark.cov,cases,chr17,76325865,76325865,11.7647058823529,8,60,68
SRR25023304_1_val_1_bismark_bt2_pe.bismark.cov,cases,chr17,76325979,76325979,60.0,42,28,70
SRR25023304_1_val_1_bismark_bt2_pe.bismark.cov,cases,chr14,45604787,45604787,0.0,0,280,280
SRR25023304_1_val_1_bismark_bt2_pe.bismark.cov,cases,chr14,45604794,45604794,0.357142857142857,1,279,280
SRR25023304_1_val_1_bismark_bt2_pe.bismark.cov,cases,chr6,43543548,43543548,1.72413793103448,2,114,116
SRR25023304_1_val_1_bismark_bt2_pe.bismark.cov,cases,chr6,43543554,43543554,2.60869565217391,3,112,115
SRR25023304_1_val_1_bismark_bt2_pe.bismark.cov,cases,chr6,43543571,43543571,0.0,0,115,115
SRR25023304_1_val_1_bismark_bt2_pe.bismark.cov,cases,chr6,43543578,43543578,0.862068965517241,1,115,116
SRR25023304_1_val_1_bismark_bt2_pe.bismark.cov,cases,chr6,43543580,43543580,0.0,0,116,116
SRR25023304_1_val_1_bismark_bt2_pe.bismark.cov,cases,chr6,43543596,43543596,0.0,0,116,116
SRR25023304_1_val_1_bismark_bt2_pe.bismark.cov,cases,chr6,43543608,43543608,0.0,0,117,117
SRR25023304_1_val_1_bismark_bt2_pe.bismark.cov,cases,chr6,43543613,43543613,1.70940170940171,2,115,117
SRR25023304_1_val_1_bismark_bt2_pe.bismark.cov,cases,chr6,43543615,43543615,0.854700854700855,1,116,117
SRR25023304_1_val_1_bismark_bt2_pe.bismark.cov,cases,chr6,43543618,43543618,0.0,0,117,117
SRR25023304_1_val_1_bismark_bt2_pe.bismark.cov,cases,chr6,43543624,43543624,0.0,0,116,116
SRR25023304_1_val_1_bismark_bt2_pe.bismark.cov,cases,chr6,43543642,43543642,0.0,0,117,117
SRR25023304_1_val_1_bismark_bt2_pe.bismark.cov,cases,chr6,43543650,43543650,0.0,0,118,118
SRR25023304_1_val_1_bismark_bt2_pe.bismark.cov,cases,chr6,43543657,43543657,0.0,0,118,118
SRR25023304_1_val_1_bismark_bt2_pe.bismark.cov,cases,chr6,43543669,43543669,1.69491525423729,2,116,118
SRR25023304_1_val_1_bismark_bt2_pe.bismark.cov,cases,chr6,43543672,43543672,0.0,0,118,118
SRR25023304_1_val_1_bismark_bt2_pe.bismark.cov,cases,chr6,43543682,43543682,0.0,0,118,118
SRR25023304_1_val_1_bismark_bt2_pe.bismark.cov,cases,chr6,43543691,43543691,0.854700854700855,1,116,117
SRR25023304_1_val_1_bismark_bt2_pe.bismark.cov,cases,chr6,43543696,43543696,6.83760683760684,8,109,117
SRR25023304_1_val_1_bismark_bt2_pe.bismark.cov,cases,chr6,43543698,43543698,0.0,0,117,117
SRR25023304_1_val_1_bismark_bt2_pe.bismark.cov,cases,chr6,43543701,43543701,1.70940170940171,2,115,117
SRR25023304_1_val_1_bismark_bt2_pe.bismark.cov,cases,chr6,43543705,43543705,1.70940170940171,2,115,117
SRR25023304_1_val_1_bismark_bt2_pe.bismark.cov,cases,chr6,43543708,43543708,0.0,0,116,116
SRR25023304_1_val_1_bismark_bt2_pe.bismark.cov,cases,chr6,43543733,43543733,0.0,0,118,118
SRR25023304_1_val_1_bismark_bt2_pe.bismark.cov,cases,chr6,43543747,43543747,0.847457627118644,1,117,118
SRR25023304_1_val_1_bismark_bt2_pe.bismark.cov,cases,chr6,43543749,43543749,0.840336134453782,1,118,119
SRR25023304_1_val_1_bismark_bt2_pe.bismark.cov,cases,chr6,43543763,43543763,0.0,0,117,117
SRR25023304_1_val_1_bismark_bt2_pe.bismark.cov,cases,chr6,43543766,43543766,0.0,0,117,117
SRR25023304_1_val_1_bismark_bt2_pe.bismark.cov,cases,chr6,43543771,43543771,0.869565217391304,1,114,115
SRR25023304_1_val_1_bismark_bt2_pe.bismark.cov,cases,chr6,43543775,43543775,1.76991150442478,2,111,113
SRR25023304_1_val_1_bismark_bt2_pe.bismark.cov,cases,chr6,43543777,43543777,0.892857142857143,1,111,112
SRR25023304_1_val_1_bismark_bt2_pe.bismark.cov,cases,chr6,43543781,43543781,0.0,0,112,112
SRR25023304_1_val_1_bismark_bt2_pe.bismark.cov,cases,chr6,43543786,43543786,0.884955752212389,1,112,113
SRR25023304_1_val_1_bismark_bt2_pe.bismark.cov,cases,chr6,43543794,43543794,0.0,0,114,114
SRR25023304_1_val_1_bismark_bt2_pe.bismark.cov,cases,chr6,43543798,43543798,0.0,0,115,115
SRR25023304_1_val_1_bismark_bt2_pe.bismark.cov,cases,chr6,43543800,43543800,0.869565217391304,1,114,115
SRR25023304_1_val_1_bismark_bt2_pe.bismark.cov,cases,chr6,43543804,43543804,0.0,0,115,115
SRR25023304_1_val_1_bismark_bt2_pe.bismark.cov,cases,chr6,43543806,43543806,2.58620689655172,3,113,116
SRR25023304_1_val_1_bismark_bt2_pe.bismark.cov,cases,chr6,43543815,43543815,1.68067226890756,2,117,119
SRR25023304_1_val_1_bismark_bt2_pe.bismark.cov,cases,chr6,43543822,43543822,0.847457627118644,1,117,118
SRR25023304_1_val_1_bismark_bt2_pe.bismark.cov,cases,chr6,166980423,166980423,0.0,0,40,40
SRR25023304_1_val_1_bismark_bt2_pe.bismark.cov,cases,chr6,166980458,166980458,97.6190476190476,41,1,42
SRR25023304_1_val_1_bismark_bt2_pe.bismark.cov,cases,chr6,166980461,166980461,97.6190476190476,41,1,42
SRR25023304_1_val_1_bismark_bt2_pe.bismark.cov,cases,chr6,166980514,166980514,97.7272727272727,43,1,44
SRR25023304_1_val_1_bismark_bt2_pe.bismark.cov,cases,chr6,166980619,166980619,97.8260869565217,45,1,46
SRR25023304_1_val_1_bismark_bt2_pe.bismark.cov,cases,chr6,166980630,166980630,97.8260869565217,45,1,46
SRR25023304_1_val_1_bismark_bt2_pe.bismark.cov,cases,chrX,14891454,14891454,21.4146023468057,657,2411,3068
SRR25023304_1_val_1_bismark_bt2_pe.bismark.cov,cases,chrX,14891470,14891470,15.2315720808871,467,2599,3066
SRR25023304_1_val_1_bismark_bt2_pe.bismark.cov,cases,chrX,14891474,14891474,35.6631989596879,1097,1979,3076
SRR25023304_1_val_1_bismark_bt2_pe.bismark.cov,cases,chrX,14891488,14891488,24.8942401561992,765,2308,3073
SRR25023304_1_val_1_bismark_bt2_pe.bismark.cov,cases,chrX,14891493,14891493,43.6031331592689,1336,1728,3064
SRR25023304_1_val_1_bismark_bt2_pe.bismark.cov,cases,chrX,14891496,14891496,29.3658536585366,903,2172,3075
SRR25023304_1_val_1_bismark_bt2_pe.bismark.cov,cases,chrX,14891499,14891499,21.19140625,651,2421,3072
SRR25023304_1_val_1_bismark_bt2_pe.bismark.cov,cases,chrX,14891509,14891509,41.7371502927781,1283,1791,3074
SRR25023304_1_val_1_bismark_bt2_pe.bismark.cov,cases,chrX,14891516,14891516,44.8826597131682,1377,1691,3068
SRR25023304_1_val_1_bismark_bt2_pe.bismark.cov,cases,chrX,14891524,14891524,23.9413680781759,735,2335,3070
SRR25023304_1_val_1_bismark_bt2_pe.bismark.cov,cases,chrX,14891526,14891526,30.7014681892333,941,2124,3065
SRR25023304_1_val_1_bismark_bt2_pe.bismark.cov,cases,chrX,14891530,14891530,40.1238591916558,1231,1837,3068
SRR25023304_1_val_1_bismark_bt2_pe.bismark.cov,cases,chr7,6048869,6048869,0.464653169598407,14,2999,3013
SRR25023304_1_val_1_bismark_bt2_pe.bismark.cov,cases,chr7,6048876,6048876,0.298606502986065,9,3005,3014
SRR25023304_1_val_1_bismark_bt2_pe.bismark.cov,cases,chr7,6048884,6048884,0.166057788110262,5,3006,3011
SRR25023304_1_val_1_bismark_bt2_pe.bismark.cov,cases,chr7,6048888,6048888,0.266400266400266,8,2995,3003
SRR25023304_1_val_1_bismark_bt2_pe.bismark.cov,cases,chr7,6048892,6048892,0.331895121141719,10,3003,3013
SRR25023304_1_val_1_bismark_bt2_pe.bismark.cov,cases,chr7,6048904,6048904,0.0,0,646,646
SRR25023304_1_val_1_bismark_bt2_pe.bismark.cov,cases,chr7,6048918,6048918,0.165672630881378,5,3013,3018
SRR25023304_1_val_1_bismark_bt2_pe.bismark.cov,cases,chr7,6048925,6048925,0.464344941956882,14,3001,3015
SRR25023304_1_val_1_bismark_bt2_pe.bismark.cov,cases,chr7,6048928,6048928,0.596026490066225,18,3002,3020
SRR25023304_1_val_1_bismark_bt2_pe.bismark.cov,cases,chr7,6048940,6048940,0.529450694904037,16,3006,3022
SRR25023304_1_val_1_bismark_bt2_pe.bismark.cov,cases,chr7,6048951,6048951,0.363756613756614,11,3013,3024
SRR25023304_1_val_1_bismark_bt2_pe.bismark.cov,cases,chr7,6048966,6048966,0.694214876033058,21,3004,3025
SRR25023304_1_val_1_bismark_bt2_pe.bismark.cov,cases,chr7,6048968,6048968,0.464961806708735,14,2997,3011
SRR25023304_1_val_1_bismark_bt2_pe.bismark.cov,cases,chr16,23652769,23652769,0.606060606060606,3,492,495
SRR25023304_1_val_1_bismark_bt2_pe.bismark.cov,cases,chr16,23652783,23652783,0.804828973843058,4,493,497
SRR25023304_1_val_1_bismark_bt2_pe.bismark.cov,cases,chr16,23652787,23652787,0.803212851405622,4,494,498
SRR25023304_1_val_1_bismark_bt2_pe.bismark.cov,cases,chr16,23652797,23652797,0.404040404040404,2,493,495
SRR25023304_1_val_1_bismark_bt2_pe.bismark.cov,cases,chr16,23652818,23652818,0.404858299595142,2,492,494
SRR25023304_1_val_1_bismark_bt2_pe.bismark.cov,cases,chr16,23652838,23652838,1.01214574898785,5,489,494
SRR25023304_1_val_1_bismark_bt2_pe.bismark.cov,cases,chr16,23652857,23652857,0.399201596806387,2,499,501
SRR25023304_1_val_1_bismark_bt2_pe.bismark.cov,cases,chr16,23652860,23652860,0.6,3,497,500
SRR25023304_1_val_1_bismark_bt2_pe.bismark.cov,cases,chr16,23652876,23652876,0.6,3,497,500
SRR25023304_1_val_1_bismark_bt2_pe.bismark.cov,cases,chr16,23652906,23652906,0.4,2,498,500
SRR25023304_1_val_1_bismark_bt2_pe.bismark.cov,cases,chr16,23652911,23652911,1.40280561122244,7,492,499
SRR25023304_1_val_1_bismark_bt2_pe.bismark.cov,cases,chr16,23652916,23652916,0.824742268041237,4,481,485
SRR25023304_1_val_1_bismark_bt2_pe.bismark.cov,cases,chr16,23652918,23652918,0.0,0,498,498
SRR25023305_1_val_1_bismark_bt2_pe.bismark.cov,cases,chr13,32889392,32889392,18.7461773700306,613,2657,3270
SRR25023305_1_val_1_bismark_bt2_pe.bismark.cov,cases,chr13,32889434,32889434,2.81776416539051,92,3173,3265
SRR25023305_1_val_1_bismark_bt2_pe.bismark.cov,cases,chr13,32889461,32889461,0.706605222734255,23,3232,3255
SRR25023305_1_val_1_bismark_bt2_pe.bismark.cov,cases,chr13,32889470,32889470,0.368211107701749,12,3247,3259
SRR25023305_1_val_1_bismark_bt2_pe.bismark.cov,cases,chr13,32889484,32889484,0.55367579206398,18,3233,3251
SRR25023305_1_val_1_bismark_bt2_pe.bismark.cov,cases,chr13,108867034,108867034,38.4463462804477,584,935,1519
SRR25023305_1_val_1_bismark_bt2_pe.bismark.cov,cases,chr13,108867035,108867035,2.94117647058824,1,33,34
SRR25023305_1_val_1_bismark_bt2_pe.bismark.cov,cases,chr13,108867044,108867044,46.1093247588424,717,838,1555
SRR25023305_1_val_1_bismark_bt2_pe.bismark.cov,cases,chr13,108867051,108867051,45.6185567010309,708,844,1552
SRR25023305_1_val_1_bismark_bt2_pe.bismark.cov,cases,chr13,108867109,108867109,73.19257837492,1144,419,1563
SRR25023305_1_val_1_bismark_bt2_pe.bismark.cov,cases,chr13,108867112,108867112,81.9693094629156,1282,282,1564
SRR25023305_1_val_1_bismark_bt2_pe.bismark.cov,cases,chr13,108867124,108867124,63.3802816901408,990,572,1562
SRR25023305_1_val_1_bismark_bt2_pe.bismark.cov,cases,chr13,108867135,108867135,55.6125721616421,867,692,1559
SRR25023305_1_val_1_bismark_bt2_pe.bismark.cov,cases,chr13,108867155,108867155,50.096215522771,781,778,1559
SRR25023305_1_val_1_bismark_bt2_pe.bismark.cov,cases,chr2,47596828,47596828,3.06065664997218,55,1742,1797
SRR25023305_1_val_1_bismark_bt2_pe.bismark.cov,cases,chr2,47596830,47596830,3.6204059243006,66,1757,1823
SRR25023305_1_val_1_bismark_bt2_pe.bismark.cov,cases,chr2,47596840,47596840,3.62239297475302,66,1756,1822
SRR25023305_1_val_1_bismark_bt2_pe.bismark.cov,cases,chr2,47596849,47596849,16.9686985172982,309,1512,1821
SRR25023305_1_val_1_bismark_bt2_pe.bismark.cov,cases,chr2,47596853,47596853,5.43060888645091,99,1724,1823
SRR25023305_1_val_1_bismark_bt2_pe.bismark.cov,cases,chr2,47596858,47596858,10.3675260559517,189,1634,1823
SRR25023305_1_val_1_bismark_bt2_pe.bismark.cov,cases,chr2,47596862,47596862,9.44017563117453,172,1650,1822
SRR25023305_1_val_1_bismark_bt2_pe.bismark.cov,cases,chr2,47596869,47596869,21.1074561403509,385,1439,1824
SRR25023305_1_val_1_bismark_bt2_pe.bismark.cov,cases,chr2,47596883,47596883,13.5938359933957,247,1570,1817
SRR25023305_1_val_1_bismark_bt2_pe.bismark.cov,cases,chr2,47596885,47596885,3.91184573002755,71,1744,1815
SRR25023305_1_val_1_bismark_bt2_pe.bismark.cov,cases,chr2,47596887,47596887,7.26872246696035,132,1684,1816
SRR25023305_1_val_1_bismark_bt2_pe.bismark.cov,cases,chr2,47596897,47596897,5.38461538461539,98,1722,1820
SRR25023305_1_val_1_bismark_bt2_pe.bismark.cov,cases,chr2,47596900,47596900,3.90969162995595,71,1745,1816
SRR25023305_1_val_1_bismark_bt2_pe.bismark.cov,cases,chr2,47596907,47596907,4.07488986784141,74,1742,1816
SRR25023305_1_val_1_bismark_bt2_pe.bismark.cov,cases,chr2,47596912,47596912,3.35903083700441,61,1755,1816
SRR25023305_1_val_1_bismark_bt2_pe.bismark.cov,cases,chr2,47596930,47596930,5.69690265486726,103,1705,1808
SRR25023305_1_val_1_bismark_bt2_pe.bismark.cov,cases,chr2,47596942,47596942,6.72546857772878,122,1692,1814
SRR25023305_1_val_1_bismark_bt2_pe.bismark.cov,cases,chr2,47630224,47630224,0.922045264040235,11,1182,1193
SRR25023305_1_val_1_bismark_bt2_pe.bismark.cov,cases,chr2,47630227,47630227,0.658978583196046,8,1206,1214
SRR25023305_1_val_1_bismark_bt2_pe.bismark.cov,cases,chr2,47630233,47630233,0.740740740740741,9,1206,1215
SRR25023305_1_val_1_bismark_bt2_pe.bismark.cov,cases,chr2,47630237,47630237,0.494233937397035,6,1208,1214
SRR25023305_1_val_1_bismark_bt2_pe.bismark.cov,cases,chr2,47630240,47630240,1.97693574958814,24,1190,1214
SRR25023305_1_val_1_bismark_bt2_pe.bismark.cov,cases,chr2,47630244,47630244,1.15702479338843,14,1196,1210
SRR25023305_1_val_1_bismark_bt2_pe.bismark.cov,cases,chr2,47630251,47630251,0.577081615828524,7,1206,1213
SRR25023305_1_val_1_bismark_bt2_pe.bismark.cov,cases,chr2,47630265,47630265,0.658978583196046,8,1206,1214
SRR25023305_1_val_1_bismark_bt2_pe.bismark.cov,cases,chr2,47630292,47630292,0.496277915632754,6,1203,1209
SRR25023305_1_val_1_bismark_bt2_pe.bismark.cov,cases,chr2,47630294,47630294,0.412201154163232,5,1208,1213
SRR25023305_1_val_1_bismark_bt2_pe.bismark.cov,cases,chr2,128051674,128051674,0.0,0,225,225
SRR25023305_1_val_1_bismark_bt2_pe.bismark.cov,cases,chr2,128051690,128051690,0.31813361611877,3,940,943
SRR25023305_1_val_1_bismark_bt2_pe.bismark.cov,cases,chr2,128051704,128051704,0.531914893617021,5,935,940
SRR25023305_1_val_1_bismark_bt2_pe.bismark.cov,cases,chr2,128051707,128051707,0.31813361611877,3,940,943
SRR25023305_1_val_1_bismark_bt2_pe.bismark.cov,cases,chr2,128051709,128051709,1.48777895855473,14,927,941
SRR25023305_1_val_1_bismark_bt2_pe.bismark.cov,cases,chr2,128051716,128051716,0.106382978723404,1,939,940
SRR25023305_1_val_1_bismark_bt2_pe.bismark.cov,cases,chr2,128051733,128051733,0.423728813559322,4,940,944
SRR25023305_1_val_1_bismark_bt2_pe.bismark.cov,cases,chr2,128051743,128051743,1.58898305084746,15,929,944
SRR25023305_1_val_1_bismark_bt2_pe.bismark.cov,cases,chr2,178787742,178787742,91.9614147909968,286,25,311
SRR25023305_1_val_1_bismark_bt2_pe.bismark.cov,cases,chr2,241151145,241151145,100.0,23,0,23
SRR25023305_1_val_1_bismark_bt2_pe.bismark.cov,cases,chr2,241151165,241151165,96.0,24,1,25
SRR25023305_1_val_1_bismark_bt2_pe.bismark.cov,cases,chr2,241151205,241151205,96.1538461538462,25,1,26
SRR25023305_1_val_1_bismark_bt2_pe.bismark.cov,cases,chr2,241151217,241151217,96.1538461538462,25,1,26
SRR25023305_1_val_1_bismark_bt2_pe.bismark.cov,cases,chr2,241151277,241151277,0.0,0,22,22
SRR25023305_1_val_1_bismark_bt2_pe.bismark.cov,cases,chr3,37034307,37034307,99.8690671031097,3051,4,3055
SRR25023305_1_val_1_bismark_bt2_pe.bismark.cov,cases,chr3,37034316,37034316,0.523388943408571,16,3041,3057
SRR25023305_1_val_1_bismark_bt2_pe.bismark.cov,cases,chr3,37034324,37034324,0.65402223675605,20,3038,3058
SRR25023305_1_val_1_bismark_bt2_pe.bismark.cov,cases,chr3,37034330,37034330,0.327118089630357,10,3047,3057
SRR25023305_1_val_1_bismark_bt2_pe.bismark.cov,cases,chr3,37034344,37034344,1.07984293193717,33,3023,3056
SRR25023305_1_val_1_bismark_bt2_pe.bismark.cov,cases,chr3,37034346,37034346,0.425392670157068,13,3043,3056
SRR25023305_1_val_1_bismark_bt2_pe.bismark.cov,cases,chr3,37034348,37034348,0.653381247958184,20,3041,3061
SRR25023305_1_val_1_bismark_bt2_pe.bismark.cov,cases,chr3,37034352,37034352,0.84911822338341,26,3036,3062
SRR25023305_1_val_1_bismark_bt2_pe.bismark.cov,cases,chr3,37034355,37034355,0.751633986928105,23,3037,3060
SRR25023305_1_val_1_bismark_bt2_pe.bismark.cov,cases,chr3,37034359,37034359,0.718015665796345,22,3042,3064
SRR25023305_1_val_1_bismark_bt2_pe.bismark.cov,cases,chr3,37034369,37034369,0.903312144529943,27,2962,2989
SRR25023305_1_val_1_bismark_bt2_pe.bismark.cov,cases,chr3,37034373,37034373,0.848010437051533,26,3040,3066
SRR25023305_1_val_1_bismark_bt2_pe.bismark.cov,cases,chr3,37034382,37034382,0.751143043762247,23,3039,3062
SRR25023305_1_val_1_bismark_bt2_pe.bismark.cov,cases,chr3,37034394,37034394,0.261437908496732,8,3052,3060
SRR25023305_1_val_1_bismark_bt2_pe.bismark.cov,cases,chr3,37034402,37034402,0.392670157068063,12,3044,3056
SRR25023305_1_val_1_bismark_bt2_pe.bismark.cov,cases,chr3,37034409,37034409,0.29382957884427,9,3054,3063
SRR25023305_1_val_1_bismark_bt2_pe.bismark.cov,cases,chr3,37034412,37034412,1.04540999673309,32,3029,3061
SRR25023305_1_val_1_bismark_bt2_pe.bismark.cov,cases,chr3,37034414,37034414,1.01340307289964,31,3028,3059
SRR25023305_1_val_1_bismark_bt2_pe.bismark.cov,cases,chr3,37034418,37034418,0.816726559947729,25,3036,3061
SRR25023305_1_val_1_bismark_bt2_pe.bismark.cov,cases,chr3,37034420,37034420,0.457516339869281,14,3046,3060
SRR25023305_1_val_1_bismark_bt2_pe.bismark.cov,cases,chr3,37034430,37034430,0.654236179260713,20,3037,3057
SRR25023305_1_val_1_bismark_bt2_pe.bismark.cov,cases,chr3,37034438,37034438,0.818866688503112,25,3028,3053
SRR25023305_1_val_1_bismark_bt2_pe.bismark.cov,cases,chr3,37034441,37034441,0.850228907782865,26,3032,3058
SRR25023305_1_val_1_bismark_bt2_pe.bismark.cov,cases,chr3,37034466,37034466,99.9013157894737,3037,3,3040
SRR25023305_1_val_1_bismark_bt2_pe.bismark.cov,cases,chr3,37034997,37034997,0.34965034965035,15,4275,4290
SRR25023305_1_val_1_bismark_bt2_pe.bismark.cov,cases,chr3,37035012,37035012,0.256410256410256,11,4279,4290
SRR25023305_1_val_1_bismark_bt2_pe.bismark.cov,cases,chr3,37035032,37035032,0.372873456070846,16,4275,4291
SRR25023305_1_val_1_bismark_bt2_pe.bismark.cov,cases,chr3,37035043,37035043,0.535381750465549,23,4273,4296
SRR25023305_1_val_1_bismark_bt2_pe.bismark.cov,cases,chr3,37035047,37035047,0.628053035589672,27,4272,4299
SRR25023305_1_val_1_bismark_bt2_pe.bismark.cov,cases,chr3,37035063,37035063,0.442477876106195,19,4275,4294
SRR25023305_1_val_1_bismark_bt2_pe.bismark.cov,cases,chr3,37035066,37035066,0.418702023726448,18,4281,4299
SRR25023305_1_val_1_bismark_bt2_pe.bismark.cov,cases,chr3,37035074,37035074,0.744359153291463,32,4267,4299
SRR25023305_1_val_1_bismark_bt2_pe.bismark.cov,cases,chr3,37035090,37035090,0.791065611912518,34,4264,4298
SRR25023305_1_val_1_bismark_bt2_pe.bismark.cov,cases,chr3,37035095,37035095,0.604510578935131,26,4275,4301
SRR25023305_1_val_1_bismark_bt2_pe.bismark.cov,cases,chr3,37035097,37035097,0.697836706210747,30,4269,4299
SRR25023305_1_val_1_bismark_bt2_pe.bismark.cov,cases,chr3,37035100,37035100,0.395993477754484,17,4276,4293
SRR25023305_1_val_1_bismark_bt2_pe.bismark.cov,cases,chr3,37035117,37035117,0.557880055788006,24,4278,4302
SRR25023305_1_val_1_bismark_bt2_pe.bismark.cov,cases,chr3,142297977,142297977,0.331858407079646,3,901,904
SRR25023305_1_val_1_bismark_bt2_pe.bismark.cov,cases,chr3,142298019,142298019,0.662983425414365,6,899,905
SRR25023305_1_val_1_bismark_bt2_pe.bismark.cov,cases,chr3,142298045,142298045,0.884955752212389,8,896,904
SRR25023305_1_val_1_bismark_bt2_pe.bismark.cov,cases,chr3,142298054,142298054,3.5437430786268,32,871,903
SRR25023305_1_val_1_bismark_bt2_pe.bismark.cov,cases,chr10,89619506,89619506,97.9274611398964,1134,24,1158
SRR25023305_1_val_1_bismark_bt2_pe.bismark.cov,cases,chr10,89619510,89619510,97.7624784853701,1136,26,1162
SRR25023305_1_val_1_bismark_bt2_pe.bismark.cov,cases,chr10,89619512,89619512,98.7962166809974,1149,14,1163
SRR25023305_1_val_1_bismark_bt2_pe.bismark.cov,cases,chr10,89619522,89619522,98.5395189003437,1147,17,1164
SRR25023305_1_val_1_bismark_bt2_pe.bismark.cov,cases,chr10,89619550,89619550,97.934595524957,1138,24,1162
SRR25023305_1_val_1_bismark_bt2_pe.bismark.cov,cases,chr10,89619555,89619555,98.1067125645439,1140,22,1162
SRR25023305_1_val_1_bismark_bt2_pe.bismark.cov,cases,chr10,89619566,89619566,93.5177182368194,1082,75,1157
SRR25023305_1_val_1_bismark_bt2_pe.bismark.cov,cases,chr10,89619580,89619580,93.7984496124031,1089,72,1161
SRR25023305_1_val_1_bismark_bt2_pe.bismark.cov,cases,chr8,30890012,30890012,67.8456591639871,422,200,622
SRR25023305_1_val_1_bismark_bt2_pe.bismark.cov,cases,chr8,30890034,30890034,73.7785016286645,453,161,614
SRR25023305_1_val_1_bismark_bt2_pe.bismark.cov,cases,chr8,30890051,30890051,94.9013157894737,577,31,608
SRR25023305_1_val_1_bismark_bt2_pe.bismark.cov,cases,chr8,30890057,30890057,80.1313628899836,488,121,609
SRR25023305_1_val_1_bismark_bt2_pe.bismark.cov,cases,chr8,30890073,30890073,56.3011456628478,344,267,611
SRR25023305_1_val_1_bismark_bt2_pe.bismark.cov,cases,chr8,30890108,30890108,14.6381578947368,89,519,608
SRR25023305_1_val_1_bismark_bt2_pe.bismark.cov,cases,chr8,30890133,30890133,28.33607907743,172,435,607
SRR25023305_1_val_1_bismark_bt2_pe.bismark.cov,cases,chr8,30890139,30890139,51.4802631578947,313,295,608
SRR25023305_1_val_1_bismark_bt2_pe.bismark.cov,cases,chr8,30890145,30890145,13.673805601318,83,524,607
SRR25023305_1_val_1_bismark_bt2_pe.bismark.cov,cases,chr8,30890170,30890170,20.2321724709784,122,481,603
SRR25023305_1_val_1_bismark_bt2_pe.bismark.cov,cases,chr8,30890172,30890172,17.6859504132231,107,498,605
SRR25023305_1_val_1_bismark_bt2_pe.bismark.cov,cases,chr8,90997245,90997245,28.4210526315789,27,68,95
SRR25023305_1_val_1_bismark_bt2_pe.bismark.cov,cases,chr8,90997299,90997299,2.22222222222222,2,88,90
SRR25023305_1_val_1_bismark_bt2_pe.bismark.cov,cases,chr8,90997454,90997454,26.9230769230769,21,57,78
SRR25023305_1_val_1_bismark_bt2_pe.bismark.cov,cases,chr8,90997482,90997482,96.2025316455696,76,3,79
SRR25023305_1_val_1_bismark_bt2_pe.bismark.cov,cases,chr6,43543548,43543548,0.72463768115942,1,137,138
SRR25023305_1_val_1_bismark_bt2_pe.bismark.cov,cases,chr6,43543554,43543554,2.18978102189781,3,134,137
SRR25023305_1_val_1_bismark_bt2_pe.bismark.cov,cases,chr6,43543571,43543571,0.719424460431655,1,138,139
SRR25023305_1_val_1_bismark_bt2_pe.bismark.cov,cases,chr6,43543578,43543578,0.0,0,139,139
SRR25023305_1_val_1_bismark_bt2_pe.bismark.cov,cases,chr6,43543580,43543580,1.43884892086331,2,137,139
SRR25023305_1_val_1_bismark_bt2_pe.bismark.cov,cases,chr6,43543596,43543596,0.719424460431655,1,138,139
SRR25023305_1_val_1_bismark_bt2_pe.bismark.cov,cases,chr6,43543608,43543608,0.0,0,139,139
SRR25023305_1_val_1_bismark_bt2_pe.bismark.cov,cases,chr6,43543613,43543613,1.43884892086331,2,137,139
SRR25023305_1_val_1_bismark_bt2_pe.bismark.cov,cases,chr6,43543615,43543615,0.0,0,139,139
SRR25023305_1_val_1_bismark_bt2_pe.bismark.cov,cases,chr6,43543618,43543618,0.0,0,139,139
SRR25023305_1_val_1_bismark_bt2_pe.bismark.cov,cases,chr6,43543624,43543624,0.72992700729927,1,136,137
SRR25023305_1_val_1_bismark_bt2_pe.bismark.cov,cases,chr6,43543642,43543642,0.72463768115942,1,137,138
SRR25023305_1_val_1_bismark_bt2_pe.bismark.cov,cases,chr6,43543650,43543650,0.719424460431655,1,138,139
SRR25023305_1_val_1_bismark_bt2_pe.bismark.cov,cases,chr6,43543657,43543657,0.72463768115942,1,137,138
SRR25023305_1_val_1_bismark_bt2_pe.bismark.cov,cases,chr6,43543669,43543669,0.735294117647059,1,135,136
SRR25023305_1_val_1_bismark_bt2_pe.bismark.cov,cases,chr6,43543672,43543672,0.0,0,136,136
SRR25023305_1_val_1_bismark_bt2_pe.bismark.cov,cases,chr6,43543682,43543682,0.72992700729927,1,136,137
SRR25023305_1_val_1_bismark_bt2_pe.bismark.cov,cases,chr6,43543691,43543691,0.0,0,137,137
SRR25023305_1_val_1_bismark_bt2_pe.bismark.cov,cases,chr6,43543696,43543696,7.35294117647059,10,126,136
SRR25023305_1_val_1_bismark_bt2_pe.bismark.cov,cases,chr6,43543698,43543698,0.740740740740741,1,134,135
SRR25023305_1_val_1_bismark_bt2_pe.bismark.cov,cases,chr6,43543701,43543701,3.73134328358209,5,129,134
SRR25023305_1_val_1_bismark_bt2_pe.bismark.cov,cases,chr6,43543705,43543705,0.0,0,135,135
SRR25023305_1_val_1_bismark_bt2_pe.bismark.cov,cases,chr6,43543708,43543708,0.740740740740741,1,134,135
SRR25023305_1_val_1_bismark_bt2_pe.bismark.cov,cases,chr6,43543733,43543733,0.0,0,129,129
SRR25023305_1_val_1_bismark_bt2_pe.bismark.cov,cases,chr6,43543747,43543747,0.78125,1,127,128
SRR25023305_1_val_1_bismark_bt2_pe.bismark.cov,cases,chr6,43543749,43543749,0.78740157480315,1,126,127
SRR25023305_1_val_1_bismark_bt2_pe.bismark.cov,cases,chr6,43543763,43543763,0.0,0,124,124
SRR25023305_1_val_1_bismark_bt2_pe.bismark.cov,cases,chr6,43543766,43543766,0.813008130081301,1,122,123
SRR25023305_1_val_1_bismark_bt2_pe.bismark.cov,cases,chr6,43543771,43543771,0.806451612903226,1,123,124
SRR25023305_1_val_1_bismark_bt2_pe.bismark.cov,cases,chr6,43543775,43543775,1.6,2,123,125
SRR25023305_1_val_1_bismark_bt2_pe.bismark.cov,cases,chr6,43543777,43543777,0.0,0,125,125
SRR25023305_1_val_1_bismark_bt2_pe.bismark.cov,cases,chr6,43543781,43543781,0.0,0,126,126
SRR25023305_1_val_1_bismark_bt2_pe.bismark.cov,cases,chr6,43543786,43543786,0.793650793650794,1,125,126
SRR25023305_1_val_1_bismark_bt2_pe.bismark.cov,cases,chr6,43543794,43543794,0.806451612903226,1,123,124
SRR25023305_1_val_1_bismark_bt2_pe.bismark.cov,cases,chr6,43543798,43543798,0.806451612903226,1,123,124
SRR25023305_1_val_1_bismark_bt2_pe.bismark.cov,cases,chr6,43543800,43543800,0.826446280991736,1,120,121
SRR25023305_1_val_1_bismark_bt2_pe.bismark.cov,cases,chr6,43543804,43543804,0.0,0,121,121
SRR25023305_1_val_1_bismark_bt2_pe.bismark.cov,cases,chr6,43543806,43543806,0.0,0,121,121
SRR25023305_1_val_1_bismark_bt2_pe.bismark.cov,cases,chr6,43543815,43543815,0.840336134453782,1,118,119
SRR25023305_1_val_1_bismark_bt2_pe.bismark.cov,cases,chr6,43543822,43543822,0.0,0,120,120
SRR25023305_1_val_1_bismark_bt2_pe.bismark.cov,cases,chr6,166980423,166980423,0.0,0,44,44
SRR25023305_1_val_1_bismark_bt2_pe.bismark.cov,cases,chr6,166980458,166980458,85.1063829787234,40,7,47
SRR25023305_1_val_1_bismark_bt2_pe.bismark.cov,cases,chr6,166980461,166980461,93.6170212765958,44,3,47
SRR25023305_1_val_1_bismark_bt2_pe.bismark.cov,cases,chr6,166980514,166980514,100.0,47,0,47
SRR25023305_1_val_1_bismark_bt2_pe.bismark.cov,cases,chr6,166980619,166980619,90.0,45,5,50
SRR25023305_1_val_1_bismark_bt2_pe.bismark.cov,cases,chr6,166980630,166980630,100.0,50,0,50
SRR25023305_1_val_1_bismark_bt2_pe.bismark.cov,cases,chr11,108093323,108093323,0.460829493087558,4,864,868
SRR25023305_1_val_1_bismark_bt2_pe.bismark.cov,cases,chr11,108093335,108093335,0.806451612903226,7,861,868
SRR25023305_1_val_1_bismark_bt2_pe.bismark.cov,cases,chr11,108093338,108093338,0.694444444444444,6,858,864
SRR25023305_1_val_1_bismark_bt2_pe.bismark.cov,cases,chr11,108093359,108093359,0.234192037470726,2,852,854
SRR25023305_1_val_1_bismark_bt2_pe.bismark.cov,cases,chr11,108093371,108093371,0.3125,2,638,640
SRR25023305_1_val_1_bismark_bt2_pe.bismark.cov,cases,chr11,108093373,108093373,0.0,0,640,640
SRR25023305_1_val_1_bismark_bt2_pe.bismark.cov,cases,chr11,108093386,108093386,0.470957613814757,3,634,637
SRR25023305_1_val_1_bismark_bt2_pe.bismark.cov,cases,chr11,108093395,108093395,0.9375,6,634,640
SRR25023305_1_val_1_bismark_bt2_pe.bismark.cov,cases,chr11,108093402,108093402,0.94488188976378,6,629,635
SRR25023305_1_val_1_bismark_bt2_pe.bismark.cov,cases,chr11,108093413,108093413,0.317965023847377,2,627,629
SRR25023305_1_val_1_bismark_bt2_pe.bismark.cov,cases,chr11,108093419,108093419,1.11287758346582,7,622,629
SRR25023305_1_val_1_bismark_bt2_pe.bismark.cov,cases,chr11,108093436,108093436,0.477707006369427,3,625,628
SRR25023305_1_val_1_bismark_bt2_pe.bismark.cov,cases,chr11,108093439,108093439,0.636942675159236,4,624,628
SRR25023305_1_val_1_bismark_bt2_pe.bismark.cov,cases,chr11,108093451,108093451,0.797448165869218,5,622,627
SRR25023305_1_val_1_bismark_bt2_pe.bismark.cov,cases,chr11,108093457,108093457,0.477707006369427,3,625,628
SRR25023305_1_val_1_bismark_bt2_pe.bismark.cov,cases,chr11,108093461,108093461,0.318979266347687,2,625,627
SRR25023305_1_val_1_bismark_bt2_pe.bismark.cov,cases,chr11,108093467,108093467,0.64,4,621,625
SRR25023305_1_val_1_bismark_bt2_pe.bismark.cov,cases,chr11,108093476,108093476,0.802568218298555,5,618,623
SRR25023305_1_val_1_bismark_bt2_pe.bismark.cov,cases,chr11,108093485,108093485,0.322061191626409,2,619,621
SRR25023305_1_val_1_bismark_bt2_pe.bismark.cov,cases,chr11,108093505,108093505,0.340715502555366,2,585,587
SRR25023305_1_val_1_bismark_bt2_pe.bismark.cov,cases,chr11,108093520,108093520,0.21551724137931,1,463,464
SRR25023305_1_val_1_bismark_bt2_pe.bismark.cov,cases,chr11,108093529,108093529,0.0,0,31,31
SRR25023305_1_val_1_bismark_bt2_pe.bismark.cov,cases,chr11,108093532,108093532,3.03030303030303,1,32,33
SRR25023305_1_val_1_bismark_bt2_pe.bismark.cov,cases,chr11,108093538,108093538,0.0,0,43,43
SRR25023305_1_val_1_bismark_bt2_pe.bismark.cov,cases,chr11,108093560,108093560,1.21457489878543,6,488,494
SRR25023305_1_val_1_bismark_bt2_pe.bismark.cov,cases,chr11,108093567,108093567,0.186915887850467,1,534,535
SRR25023305_1_val_1_bismark_bt2_pe.bismark.cov,cases,chr11,108093572,108093572,0.366300366300366,2,544,546
SRR25023305_1_val_1_bismark_bt2_pe.bismark.cov,cases,chr11,108093579,108093579,0.359066427289048,2,555,557
SRR25023305_1_val_1_bismark_bt2_pe.bismark.cov,cases,chr11,108093584,108093584,1.21107266435986,7,571,578
SRR25023305_1_val_1_bismark_bt2_pe.bismark.cov,cases,chr11,108093590,108093590,0.488599348534202,3,611,614
SRR25023305_1_val_1_bismark_bt2_pe.bismark.cov,cases,chr11,108093598,108093598,0.319488817891374,2,624,626
SRR25023305_1_val_1_bismark_bt2_pe.bismark.cov,cases,chr15,89786999,89786999,1.08108108108108,2,183,185
SRR25023305_1_val_1_bismark_bt2_pe.bismark.cov,cases,chr15,89787007,89787007,2.12765957446809,4,184,188
SRR25023305_1_val_1_bismark_bt2_pe.bismark.cov,cases,chr15,89787009,89787009,0.0,0,188,188
SRR25023305_1_val_1_bismark_bt2_pe.bismark.cov,cases,chr15,89787018,89787018,0.0,0,188,188
SRR25023305_1_val_1_bismark_bt2_pe.bismark.cov,cases,chr15,89787032,89787032,0.531914893617021,1,187,188
SRR25023305_1_val_1_bismark_bt2_pe.bismark.cov,cases,chr15,89787034,89787034,0.531914893617021,1,187,188
SRR25023305_1_val_1_bismark_bt2_pe.bismark.cov,cases,chr15,89787036,89787036,0.53475935828877,1,186,187
SRR25023305_1_val_1_bismark_bt2_pe.bismark.cov,cases,chr15,89787045,89787045,0.0,0,187,187
SRR25023305_1_val_1_bismark_bt2_pe.bismark.cov,cases,chr15,89787048,89787048,1.0752688172043,2,184,186
SRR25023305_1_val_1_bismark_bt2_pe.bismark.cov,cases,chr15,89787058,89787058,0.53475935828877,1,186,187
SRR25023305_1_val_1_bismark_bt2_pe.bismark.cov,cases,chr15,89787060,89787060,1.60427807486631,3,184,187
SRR25023305_1_val_1_bismark_bt2_pe.bismark.cov,cases,chr15,89787066,89787066,0.0,0,187,187
SRR25023305_1_val_1_bismark_bt2_pe.bismark.cov,cases,chr15,89787077,89787077,0.0,0,187,187
SRR25023305_1_val_1_bismark_bt2_pe.bismark.cov,cases,chr15,89787087,89787087,0.0,0,186,186
SRR25023305_1_val_1_bismark_bt2_pe.bismark.cov,cases,chr15,89787103,89787103,0.0,0,186,186
SRR25023305_1_val_1_bismark_bt2_pe.bismark.cov,cases,chr15,89787109,89787109,1.08108108108108,2,183,185
SRR25023305_1_val_1_bismark_bt2_pe.bismark.cov,cases,chr15,89787113,89787113,0.0,0,185,185
SRR25023305_1_val_1_bismark_bt2_pe.bismark.cov,cases,chr15,89787120,89787120,0.0,0,185,185
SRR25023305_1_val_1_bismark_bt2_pe.bismark.cov,cases,chr15,89787150,89787150,0.546448087431694,1,182,183
SRR25023305_1_val_1_bismark_bt2_pe.bismark.cov,cases,chr15,89787154,89787154,0.549450549450549,1,181,182
SRR25023305_1_val_1_bismark_bt2_pe.bismark.cov,cases,chr15,89787164,89787164,0.568181818181818,1,175,176
SRR25023305_1_val_1_bismark_bt2_pe.bismark.cov,cases,chr15,89787168,89787168,1.13636363636364,2,174,176
SRR25023305_1_val_1_bismark_bt2_pe.bismark.cov,cases,chr15,89787171,89787171,0.0,0,174,174
SRR25023305_1_val_1_bismark_bt2_pe.bismark.cov,cases,chr15,89787182,89787182,0.0,0,173,173
SRR25023305_1_val_1_bismark_bt2_pe.bismark.cov,cases,chr15,89787184,89787184,1.16279069767442,2,170,172
SRR25023305_1_val_1_bismark_bt2_pe.bismark.cov,cases,chr15,89787190,89787190,1.19047619047619,2,166,168
SRR25023305_1_val_1_bismark_bt2_pe.bismark.cov,cases,chr15,89787205,89787205,0.0,0,156,156
SRR25023305_1_val_1_bismark_bt2_pe.bismark.cov,cases,chr15,89787212,89787212,1.66666666666667,2,118,120
SRR25023305_1_val_1_bismark_bt2_pe.bismark.cov,cases,chr15,89787223,89787223,0.0,0,91,91
SRR25023305_1_val_1_bismark_bt2_pe.bismark.cov,cases,chr15,89787226,89787226,0.0,0,93,93
SRR25023305_1_val_1_bismark_bt2_pe.bismark.cov,cases,chr15,89787238,89787238,0.0,0,104,104
SRR25023305_1_val_1_bismark_bt2_pe.bismark.cov,cases,chr15,89787260,89787260,0.0,0,124,124
SRR25023305_1_val_1_bismark_bt2_pe.bismark.cov,cases,chr15,89787272,89787272,0.0,0,127,127
SRR25023305_1_val_1_bismark_bt2_pe.bismark.cov,cases,chr15,89787288,89787288,0.0,0,147,147
SRR25023305_1_val_1_bismark_bt2_pe.bismark.cov,cases,chr15,89787293,89787293,0.0,0,153,153
SRR25023305_1_val_1_bismark_bt2_pe.bismark.cov,cases,chr15,89787295,89787295,0.0,0,157,157
SRR25023305_1_val_1_bismark_bt2_pe.bismark.cov,cases,chr15,89787304,89787304,0.0,0,167,167
SRR25023305_1_val_1_bismark_bt2_pe.bismark.cov,cases,chr15,89787335,89787335,0.0,0,184,184
SRR25023305_1_val_1_bismark_bt2_pe.bismark.cov,cases,chr14,45604787,45604787,0.332225913621262,1,300,301
SRR25023305_1_val_1_bismark_bt2_pe.bismark.cov,cases,chr14,45604794,45604794,0.332225913621262,1,300,301
SRR25023305_1_val_1_bismark_bt2_pe.bismark.cov,cases,chr17,13571499,13571499,81.8181818181818,18,4,22
SRR25023305_1_val_1_bismark_bt2_pe.bismark.cov,cases,chr17,13571583,13571583,91.6666666666667,22,2,24
SRR25023305_1_val_1_bismark_bt2_pe.bismark.cov,cases,chr17,13571613,13571613,70.8333333333333,17,7,24
SRR25023305_1_val_1_bismark_bt2_pe.bismark.cov,cases,chr17,41277106,41277106,1.67427701674277,33,1938,1971
SRR25023305_1_val_1_bismark_bt2_pe.bismark.cov,cases,chr17,41277115,41277115,1.26710593005575,25,1948,1973
SRR25023305_1_val_1_bismark_bt2_pe.bismark.cov,cases,chr17,41277117,41277117,1.57520325203252,31,1937,1968
SRR25023305_1_val_1_bismark_bt2_pe.bismark.cov,cases,chr17,41277153,41277153,1.1207335710647,22,1941,1963
SRR25023305_1_val_1_bismark_bt2_pe.bismark.cov,cases,chr17,41277160,41277160,1.32315521628499,26,1939,1965
SRR25023305_1_val_1_bismark_bt2_pe.bismark.cov,cases,chr17,41277174,41277174,1.11902339776195,22,1944,1966
SRR25023305_1_val_1_bismark_bt2_pe.bismark.cov,cases,chr17,41277187,41277187,8.3073727933541,160,1766,1926
SRR25023305_1_val_1_bismark_bt2_pe.bismark.cov,cases,chr17,41277214,41277214,1.41557128412538,28,1950,1978
SRR25023305_1_val_1_bismark_bt2_pe.bismark.cov,cases,chr17,41277232,41277232,1.06060606060606,21,1959,1980
SRR25023305_1_val_1_bismark_bt2_pe.bismark.cov,cases,chr17,56769746,56769746,94.2028985507246,130,8,138
SRR25023305_1_val_1_bismark_bt2_pe.bismark.cov,cases,chr17,56769760,56769760,87.7697841726619,122,17,139
SRR25023305_1_val_1_bismark_bt2_pe.bismark.cov,cases,chr17,56769767,56769767,71.9424460431655,100,39,139
SRR25023305_1_val_1_bismark_bt2_pe.bismark.cov,cases,chr17,56769830,56769830,0.757575757575758,1,131,132
SRR25023305_1_val_1_bismark_bt2_pe.bismark.cov,cases,chr17,56769866,56769866,0.0,0,133,133
SRR25023305_1_val_1_bismark_bt2_pe.bismark.cov,cases,chr17,56769883,56769883,0.75187969924812,1,132,133
SRR25023305_1_val_1_bismark_bt2_pe.bismark.cov,cases,chr17,56769891,56769891,0.0,0,134,134
SRR25023305_1_val_1_bismark_bt2_pe.bismark.cov,cases,chr17,56769895,56769895,0.0,0,134,134
SRR25023305_1_val_1_bismark_bt2_pe.bismark.cov,cases,chr17,56769904,56769904,2.23880597014925,3,131,134
SRR25023305_1_val_1_bismark_bt2_pe.bismark.cov,cases,chr17,56769912,56769912,0.0,0,134,134
SRR25023305_1_val_1_bismark_bt2_pe.bismark.cov,cases,chr17,56769922,56769922,0.0,0,132,132
SRR25023305_1_val_1_bismark_bt2_pe.bismark.cov,cases,chr17,56769929,56769929,0.0,0,132,132
SRR25023305_1_val_1_bismark_bt2_pe.bismark.cov,cases,chr17,56769936,56769936,0.769230769230769,1,129,130
SRR25023305_1_val_1_bismark_bt2_pe.bismark.cov,cases,chr17,56769941,56769941,2.30769230769231,3,127,130
SRR25023305_1_val_1_bismark_bt2_pe.bismark.cov,cases,chr17,56769944,56769944,1.53846153846154,2,128,130
SRR25023305_1_val_1_bismark_bt2_pe.bismark.cov,cases,chr17,56769948,56769948,0.0,0,130,130
SRR25023305_1_val_1_bismark_bt2_pe.bismark.cov,cases,chr17,56769956,56769956,0.0,0,121,121
SRR25023305_1_val_1_bismark_bt2_pe.bismark.cov,cases,chr17,56769962,56769962,1.78571428571429,2,110,112
SRR25023305_1_val_1_bismark_bt2_pe.bismark.cov,cases,chr17,56769966,56769966,0.0,0,108,108
SRR25023305_1_val_1_bismark_bt2_pe.bismark.cov,cases,chr17,56769982,56769982,0.925925925925926,1,107,108
SRR25023305_1_val_1_bismark_bt2_pe.bismark.cov,cases,chr17,56770003,56770003,0.0,0,115,115
SRR25023305_1_val_1_bismark_bt2_pe.bismark.cov,cases,chr17,56770008,56770008,0.0,0,117,117
SRR25023305_1_val_1_bismark_bt2_pe.bismark.cov,cases,chr17,56770010,56770010,0.0,0,118,118
SRR25023305_1_val_1_bismark_bt2_pe.bismark.cov,cases,chr17,56770018,56770018,0.0,0,123,123
SRR25023305_1_val_1_bismark_bt2_pe.bismark.cov,cases,chr17,56770023,56770023,0.793650793650794,1,125,126
SRR25023305_1_val_1_bismark_bt2_pe.bismark.cov,cases,chr17,56770038,56770038,1.5625,2,126,128
SRR25023305_1_val_1_bismark_bt2_pe.bismark.cov,cases,chr17,56770057,56770057,0.0,0,127,127
SRR25023305_1_val_1_bismark_bt2_pe.bismark.cov,cases,chr17,56770069,56770069,0.0,0,126,126
SRR25023305_1_val_1_bismark_bt2_pe.bismark.cov,cases,chr17,56770074,56770074,0.0,0,128,128
SRR25023305_1_val_1_bismark_bt2_pe.bismark.cov,cases,chr17,56770093,56770093,0.0,0,129,129
SRR25023305_1_val_1_bismark_bt2_pe.bismark.cov,cases,chr17,59940970,59940970,0.37593984962406,1,265,266
SRR25023305_1_val_1_bismark_bt2_pe.bismark.cov,cases,chr17,59940975,59940975,1.13207547169811,3,262,265
SRR25023305_1_val_1_bismark_bt2_pe.bismark.cov,cases,chr17,59940988,59940988,0.0,0,265,265
SRR25023305_1_val_1_bismark_bt2_pe.bismark.cov,cases,chr17,59940997,59940997,0.380228136882129,1,262,263
SRR25023305_1_val_1_bismark_bt2_pe.bismark.cov,cases,chr17,59941017,59941017,0.0,0,155,155
SRR25023305_1_val_1_bismark_bt2_pe.bismark.cov,cases,chr17,59941051,59941051,0.0,0,266,266
SRR25023305_1_val_1_bismark_bt2_pe.bismark.cov,cases,chr17,59941053,59941053,0.340136054421769,1,293,294
SRR25023305_1_val_1_bismark_bt2_pe.bismark.cov,cases,chr17,59941056,59941056,0.0,0,265,265
SRR25023305_1_val_1_bismark_bt2_pe.bismark.cov,cases,chr17,59941067,59941067,0.735294117647059,2,270,272
SRR25023305_1_val_1_bismark_bt2_pe.bismark.cov,cases,chr17,59941110,59941110,0.0,0,308,308
SRR25023305_1_val_1_bismark_bt2_pe.bismark.cov,cases,chr17,59941133,59941133,0.32258064516129,1,309,310
SRR25023305_1_val_1_bismark_bt2_pe.bismark.cov,cases,chr17,59941136,59941136,0.967741935483871,3,307,310
SRR25023305_1_val_1_bismark_bt2_pe.bismark.cov,cases,chr17,59941187,59941187,0.323624595469256,1,308,309
SRR25023305_1_val_1_bismark_bt2_pe.bismark.cov,cases,chr17,59941191,59941191,0.324675324675325,1,307,308
SRR25023305_1_val_1_bismark_bt2_pe.bismark.cov,cases,chr17,59941201,59941201,0.873362445414847,2,227,229
SRR25023305_1_val_1_bismark_bt2_pe.bismark.cov,cases,chr17,59941202,59941202,0.0,0,73,73
SRR25023305_1_val_1_bismark_bt2_pe.bismark.cov,cases,chr17,76325846,76325846,50.6329113924051,40,39,79
SRR25023305_1_val_1_bismark_bt2_pe.bismark.cov,cases,chr17,76325851,76325851,48.1012658227848,38,41,79
SRR25023305_1_val_1_bismark_bt2_pe.bismark.cov,cases,chr17,76325865,76325865,30.379746835443,24,55,79
SRR25023305_1_val_1_bismark_bt2_pe.bismark.cov,cases,chr17,76325979,76325979,74.6835443037975,59,20,79
SRR25023305_1_val_1_bismark_bt2_pe.bismark.cov,cases,chrX,14891454,14891454,25.4420600858369,1482,4343,5825
SRR25023305_1_val_1_bismark_bt2_pe.bismark.cov,cases,chrX,14891470,14891470,19.3515182707154,1128,4701,5829
SRR25023305_1_val_1_bismark_bt2_pe.bismark.cov,cases,chrX,14891474,14891474,30.5831903945111,1783,4047,5830
SRR25023305_1_val_1_bismark_bt2_pe.bismark.cov,cases,chrX,14891488,14891488,25.1757845995541,1468,4363,5831
SRR25023305_1_val_1_bismark_bt2_pe.bismark.cov,cases,chrX,14891493,14891493,41.8668496911462,2440,3388,5828
SRR25023305_1_val_1_bismark_bt2_pe.bismark.cov,cases,chrX,14891496,14891496,31.1503514486542,1817,4016,5833
SRR25023305_1_val_1_bismark_bt2_pe.bismark.cov,cases,chrX,14891499,14891499,22.3519313304721,1302,4523,5825
SRR25023305_1_val_1_bismark_bt2_pe.bismark.cov,cases,chrX,14891509,14891509,41.2360515021459,2402,3423,5825
SRR25023305_1_val_1_bismark_bt2_pe.bismark.cov,cases,chrX,14891516,14891516,41.8225501973571,2437,3390,5827
SRR25023305_1_val_1_bismark_bt2_pe.bismark.cov,cases,chrX,14891524,14891524,22.5407725321888,1313,4512,5825
SRR25023305_1_val_1_bismark_bt2_pe.bismark.cov,cases,chrX,14891526,14891526,31.8462594371997,1856,3972,5828
SRR25023305_1_val_1_bismark_bt2_pe.bismark.cov,cases,chrX,14891530,14891530,34.1915550978373,1992,3834,5826
SRR25023305_1_val_1_bismark_bt2_pe.bismark.cov,cases,chr16,23652769,23652769,1.35135135135135,6,438,444
SRR25023305_1_val_1_bismark_bt2_pe.bismark.cov,cases,chr16,23652783,23652783,1.12107623318386,5,441,446
SRR25023305_1_val_1_bismark_bt2_pe.bismark.cov,cases,chr16,23652787,23652787,0.677200902934537,3,440,443
SRR25023305_1_val_1_bismark_bt2_pe.bismark.cov,cases,chr16,23652797,23652797,0.91324200913242,4,434,438
SRR25023305_1_val_1_bismark_bt2_pe.bismark.cov,cases,chr16,23652818,23652818,0.680272108843537,3,438,441
SRR25023305_1_val_1_bismark_bt2_pe.bismark.cov,cases,chr16,23652838,23652838,0.453514739229025,2,439,441
SRR25023305_1_val_1_bismark_bt2_pe.bismark.cov,cases,chr16,23652857,23652857,1.55555555555556,7,443,450
SRR25023305_1_val_1_bismark_bt2_pe.bismark.cov,cases,chr16,23652860,23652860,0.444444444444444,2,448,450
SRR25023305_1_val_1_bismark_bt2_pe.bismark.cov,cases,chr16,23652876,23652876,1.33333333333333,6,444,450
SRR25023305_1_val_1_bismark_bt2_pe.bismark.cov,cases,chr16,23652906,23652906,1.78571428571429,8,440,448
SRR25023305_1_val_1_bismark_bt2_pe.bismark.cov,cases,chr16,23652911,23652911,0.446428571428571,2,446,448
SRR25023305_1_val_1_bismark_bt2_pe.bismark.cov,cases,chr16,23652916,23652916,1.35746606334842,6,436,442
SRR25023305_1_val_1_bismark_bt2_pe.bismark.cov,cases,chr16,23652918,23652918,1.55902004454343,7,442,449
SRR25023305_1_val_1_bismark_bt2_pe.bismark.cov,cases,chr7,6048869,6048869,0.591465990705534,28,4706,4734
SRR25023305_1_val_1_bismark_bt2_pe.bismark.cov,cases,chr7,6048876,6048876,0.802873441791675,38,4695,4733
SRR25023305_1_val_1_bismark_bt2_pe.bismark.cov,cases,chr7,6048884,6048884,0.486566532684578,23,4704,4727
SRR25023305_1_val_1_bismark_bt2_pe.bismark.cov,cases,chr7,6048888,6048888,0.613496932515337,29,4698,4727
SRR25023305_1_val_1_bismark_bt2_pe.bismark.cov,cases,chr7,6048892,6048892,0.550148116800677,26,4700,4726
SRR25023305_1_val_1_bismark_bt2_pe.bismark.cov,cases,chr7,6048904,6048904,0.107181136120043,1,932,933
SRR25023305_1_val_1_bismark_bt2_pe.bismark.cov,cases,chr7,6048918,6048918,0.674820750738085,32,4710,4742
SRR25023305_1_val_1_bismark_bt2_pe.bismark.cov,cases,chr7,6048925,6048925,0.526870389884089,25,4720,4745
SRR25023305_1_val_1_bismark_bt2_pe.bismark.cov,cases,chr7,6048928,6048928,0.632111251580278,30,4716,4746
SRR25023305_1_val_1_bismark_bt2_pe.bismark.cov,cases,chr7,6048940,6048940,0.907364422874024,43,4696,4739
SRR25023305_1_val_1_bismark_bt2_pe.bismark.cov,cases,chr7,6048951,6048951,0.358649789029536,17,4723,4740
SRR25023305_1_val_1_bismark_bt2_pe.bismark.cov,cases,chr7,6048966,6048966,0.590468156895825,28,4714,4742
SRR25023305_1_val_1_bismark_bt2_pe.bismark.cov,cases,chr7,6048968,6048968,0.486566532684578,23,4704,4727
